user_id,session_id,event_index,previous,current,delta,type
" !%,5Bf""ivQz^Rw9C#lCq:sq9NoTEi4hiXYBfB",30z'M!?;`<<\iBBxB}a51W6>Zn^xJb\&?x]EzL'b5\,1,1,3,2,skip
" &lAv%^s\*iR,aEc54@+?[Alq+&LN^$xV@D-:q","R[_K<0V&pLH""aLDT&uK{UL_Mm$Szi'K@Z\}g*abua{",3,3,6,3,skip
" 5""G[_8T^pARy4>Xu?RGpGoCAyA`;9GQBj_,~`","<ze7@>p ?8EF?!|qe{l^t_gsNd{O1%EUF,<f6U}>Ca",3,3,6,3,skip
" ALd#Uh:x#dTB)>K.""D{P|9Wg{y;H(:R)ClG[z",XL|OESF'-jG!`SrmG=|}G^Lusp0w&SKLkqYC1fB';c,3,3,6,3,skip
" ALd#Uh:x#dTB)>K.""D{P|9Wg{y;H(:R)ClG[z",XL|OESF'-jG!`SrmG=|}G^Lusp0w&SKLkqYC1fB';c,4,6,13,7,skip
" ALd#Uh:x#dTB)>K.""D{P|9Wg{y;H(:R)ClG[z",XL|OESF'-jG!`SrmG=|}G^Lusp0w&SKLkqYC1fB';c,6,14,17,3,skip
" ALd#Uh:x#dTB)>K.""D{P|9Wg{y;H(:R)ClG[z",XL|OESF'-jG!`SrmG=|}G^Lusp0w&SKLkqYC1fB';c,7,17,22,5,skip
 AwIBw46%j~3F)K'%~DVQra_S7gv#Ptyk&.[C>,"}(Jd""WO-`z?@iVe**WoEyOq:pOMzJLW|^H6Mlq)PN^",1,1,5,4,skip
" QiwA#u*,>Ckr7U6[P-wMPXktz`PI0G>#e`ZL~","@O4'HC:)iu2>7OKn,h 05bbEP9:Tws=T,jW7""lzd>{",8,7,10,3,skip
 Qw(+l~oX <*`0i?a]`bzT08[uauEvZy_%/Fp~,"zN)_LZpbuu: ']!~*N""2PdDF[JI*PD_'P-1_A$F_SP",1,2,4,2,skip
 Qw(+l~oX <*`0i?a]`bzT08[uauEvZy_%/Fp~,"zN)_LZpbuu: ']!~*N""2PdDF[JI*PD_'P-1_A$F_SP",2,4,6,2,skip
 Qw(+l~oX <*`0i?a]`bzT08[uauEvZy_%/Fp~,"zN)_LZpbuu: ']!~*N""2PdDF[JI*PD_'P-1_A$F_SP",5,8,10,2,skip
" a%^NvevjK%oMgiU<X""$yPUdyh3B):e\dN9t#V",5jl;Uc2Hi)Io?hN=ohM| \Y>)J]Kwyj;(n_U/I&S [,3,9,11,2,skip
 ep:b-?Lx0VAGkvYfNkMS;jMoPLrF9\X(YeO2U,&}IXx!# [kkTj#\l%Vq:#DMA|`H;fAM(!!=fE$|_.Y,1,1,3,2,skip
" gM(;W(n$4KquK,o#P|{e{N{Vi6""6S 2,Lo]U7","m6.}g=trF'/i<i*\051gVANI9p<NdqQQs8P18RoUe""",2,2,5,3,skip
" r sJ9OwKFc Wo6,{&$kRG@!?vp0,;W+zUV)oj","@(Pc_u:nOJYn+c~z]4A%8""\{[5u[b#7<P{*ZRWv-2q",3,3,7,4,skip
" r sJ9OwKFc Wo6,{&$kRG@!?vp0,;W+zUV)oj","@(Pc_u:nOJYn+c~z]4A%8""\{[5u[b#7<P{*ZRWv-2q",4,7,10,3,skip
" yP$B~#)""3G<Buzo+'( r4n$'K/{m |3S7Wf`N","WztsA{>7 2hD+NPlASN[Zc.,\GS/FbMX-Ld9K]DL1I",2,2,4,2,skip
" yP$B~#)""3G<Buzo+'( r4n$'K/{m |3S7Wf`N","WztsA{>7 2hD+NPlASN[Zc.,\GS/FbMX-Ld9K]DL1I",3,4,6,2,skip
!2o#>OSn *]M]Dh&-9252Tl<W\qPax%{nutiWn,"i](Q1bZXkt,*n}1|qWah""1fD0CB mD-hzkBMB4^#cA",3,3,6,3,skip
"!50#{ZTK""k9m3jnM-(/bfnK0+,Sb];&$3468&G",Gc0U)s=6Ay`f/>2YGCLzM*Jsz>ttuVgtUytLqNwF<o,2,2,4,2,skip
"!50#{ZTK""k9m3jnM-(/bfnK0+,Sb];&$3468&G","]=,{QJ4Hz-I,y_vGoRugOS6]6p!Kks$f2 F}4d,dQ2",3,3,6,3,skip
!8{GAjQFcKki>ERrsT:$0v}23I<atSEJj`SESI,X$):TxZ9@:K%rV>FZNk*@WF'v>^X>iCwax`9misu`p,2,2,4,2,skip
!8{GAjQFcKki>ERrsT:$0v}23I<atSEJj`SESI,X$):TxZ9@:K%rV>FZNk*@WF'v>^X>iCwax`9misu`p,4,5,7,2,skip
"!>^XLV""a}v,Y8+""^D:GMSI=2=<=6#V9:F2N0s<","U=?px(IF}G,*:f?'>R><Bx:V%=!TU;fTCWd%e}*_uG",2,2,4,2,skip
!PExB'vuS#%:<>VPwS3)IC#RL/Z7pPOdhwsB5&,\uCU6V|#SW>a~7@;J=HH=F9/AweB+@w)`QAA]U-]i{,1,2,5,3,skip
"!Sl BF%o_EBld9V$h]*QfBcu~KT6!xrBL(""h*>",P%%3eQI){~ivy/nN<l dshh4'dL?y4SQ!|9e[QJ'1-,1,1,7,6,skip
"!Z'/o#fawX&>tBIs_K1cl_q>WL""lTI^Ao\XDi1","!QC5#qh@>3'2D;hb3[Br4hmvY^n7z,FXmI]nv<CDK!",4,2,4,2,skip
"!Z'/o#fawX&>tBIs_K1cl_q>WL""lTI^Ao\XDi1","!QC5#qh@>3'2D;hb3[Br4hmvY^n7z,FXmI]nv<CDK!",6,5,7,2,skip
!iC:j[_D^#&:Q;-8;i47_a/jzhN=&8[*tv`[a^,oMpI&DGUA9fq*[dB];PET9 hI&mQar9[sR?su@*(B&,8,11,13,2,skip
"!m#e[nV^ ,C5U&a{A.3,tJDBb;;K3P_DvlbWly","#RyeT\,]DW@Z!eN|EF0;.'R)` 8{ )u{Lr>i+P*f$A",2,6,12,6,skip
!scs0`Z&B$c^/1)8)N>UCU4Z!#f74C%[$2K]l6,"$Cn\11O0BCM3DVlSt_1%*B~_$'lLc~/gjyIa""mG=Ht",10,5,7,2,skip
!scs0`Z&B$c^/1)8)N>UCU4Z!#f74C%[$2K]l6,"$Cn\11O0BCM3DVlSt_1%*B~_$'lLc~/gjyIa""mG=Ht",15,11,13,2,skip
!scs0`Z&B$c^/1)8)N>UCU4Z!#f74C%[$2K]l6,"$Cn\11O0BCM3DVlSt_1%*B~_$'lLc~/gjyIa""mG=Ht",16,13,15,2,skip
"!z>eY,,#X/PO4bdxJxHY)!.q""; =;?`?[N`oMC","oJGTj(Z""V3&8``s~\LB]r8%kYd1#3\pM:sI6zE:stA",2,2,4,2,skip
""" #?-uh?C%DHdWj6'/~ZLEE1N{""oU1RgGg`\kM","r8Aw<i40y!{e1#)F>>m1qI+Pc]""}AX\S-g'(C$X/J'",8,8,10,2,skip
"""%^H03MD4k$t{^?l[fysnH{F8a4W![n@l|.(Gx","M$,p;%Usc>YR-4K8QTf\YkAj,G?,2uS&?&icS%:q'H",3,4,6,2,skip
"""2$?r7}2sM6.$8O)<gUtht\J<h}xEQJ. D7D$;",{\Ob0wHBhin~!rwL*n?2CG(2Wkk`SIz<lulu<:}*@M,2,2,4,2,skip
"""FM]D)HB&|.Q0N^[&eIY#/]9T~qrFT9aCx\U[<","drpY`:bP5/{AyDWj=%P[1/mI (&IyzO.B/<pEu,\/F",1,5,8,3,skip
"""FM]D)HB&|.Q0N^[&eIY#/]9T~qrFT9aCx\U[<","drpY`:bP5/{AyDWj=%P[1/mI (&IyzO.B/<pEu,\/F",3,9,11,2,skip
"""d-QR]+9m~W3ldw_C1%N?_]dL=(H gn2tJe ei","jf,W(pcJs/>.s9DFYXDD-hL.=l|2MwcUacHWv_!3V}",3,3,5,2,skip
"""d-QR]+9m~W3ldw_C1%N?_]dL=(H gn2tJe ei","jf,W(pcJs/>.s9DFYXDD-hL.=l|2MwcUacHWv_!3V}",7,8,11,3,skip
# =OktM~f5GntDkhIo`s#bXN61]Y7:ZJn9- fL,rB1EKYHm:-Xydoc+sa%opg\rL-.wjUkT*Msz*RYY%2,2,6,11,5,skip
"#+q?ez/)9YP~5V""(y""GC'l4H0ML2^_W 2g[wnK",I^7BPeU_=^EF#.DWZ.1S6{W?G?6SJ; f%IE(i5[v@2,1,1,7,6,skip
"#04W(4Ot<~k-fFt@,d[E:J=i3+2_BY_FKpp,4k","yvd,/YHR]GNz.IR)hltwMn'?3/z'3X[nOMj4'RiQRI",2,3,5,2,skip
#1k^m*uxA?Uw}!|2RKtcRmm]hpd?8S~IB10ld!,"|Ta""L)||IvvD}#>@AvOs%;Nxqx[B8o.de:?h2&_0%t",1,1,4,3,skip
#H$BSQ!RY>9b]*F*oPS6ED{9wHd-q8ZT]|c72n,"9V.[`ng^AUvs7c*4GOSe#Q`p""V$PTA2xW$j$h:/>l,",3,3,5,2,skip
#O4[in)vwK)$ULO/UUwpSn.(2Q%8I$19/j6J;w,[k-W>KIfQ7Za'HO5#!Zi0ceZbpR};`(&2 ay#U|L\v,2,2,4,2,skip
#PpL|G5^o(Qu+a*64i#tNF/V:qm\3(#dWbkyY2,P))Zb6` D*ltj8:>^j.apRPU?XmZM'5!<Zce^eeS//,9,5,7,2,skip
#\Hg%xXi8gaR+c[F;HE#XjqJJr[ U._ljpNo'*,"rkYphYgr""Jck@f3`6$>9q%ajfbmV5BWKhk*[M;Ua&b",2,2,4,2,skip
"#p%tyb*LVqM.#-q8?n`<^O=C3WxO\tfx""(T[A[","=h*W_rd-*><&|O""d@j*E%jJ@!\,bgrn{_1BRg7+EHM",3,2,4,2,skip
#pbM|P$[X8H~\h8U/~I\h=2JiCF.O%A4Db:PrL,#v}l-=Y:R!|3v&(y5f82i.xEUa$*/:&2SE&P5e79?d,1,2,1,-1,reset
"$1y_ea<w{wfzO,uM0MHFrTS""vw%8{u*RWS)7""!",PP.~TZ9-;F<@>m!EH?dCL*U_73>ejp e5zeYt*ZgEZ,7,6,8,2,skip
$2g6h{z4H$ d0xDx2i{DJnGA=p\<FoPpFJiO\A,]AIZuOp*jCce%z3Q(%;AwEugM<*#~>Ag*5vi`ru`X\,1,2,1,-1,reset
$2g6h{z4H$ d0xDx2i{DJnGA=p\<FoPpFJiO\A,]AIZuOp*jCce%z3Q(%;AwEugM<*#~>Ag*5vi`ru`X\,2,1,3,2,skip
$2g6h{z4H$ d0xDx2i{DJnGA=p\<FoPpFJiO\A,]AIZuOp*jCce%z3Q(%;AwEugM<*#~>Ag*5vi`ru`X\,4,4,6,2,skip
"$8f896p/[xy39{#PSd6X'K,a|}~,E%p1K(E^jn","IP-4v) EtxC1-6%`THnY{P7?g8co.""-Q=0=N LP[0K",2,2,4,2,skip
"$HE0jxvg/u3~iQ6U*e{0j#/^x3,""Dxw';'IxGQ",4!%SoNP]a*%=Q]g8X8AVB7[J(eXEaZS16~{#+Qgvtb,8,7,9,2,skip
$LR))+9Q-{!7O(>ETx W<z^a=s$1Mtwt/QG*Zx,"<Ft?6AZAKGdIE@>:L|$X,k""w<Cn.h/F*jy7ptvaYIW",1,2,4,2,skip
$LR))+9Q-{!7O(>ETx W<z^a=s$1Mtwt/QG*Zx,"<Ft?6AZAKGdIE@>:L|$X,k""w<Cn.h/F*jy7ptvaYIW",3,5,7,2,skip
$NlurlA>{0raX*K>eHjVh}Dmm+*amMjUPgm)Ne,2*`)Gb0'bE0Ss.(3~A4pjs(0kw^[pavR%JJ;Hsy<$L,5,5,7,2,skip
$Pg4%3Cq.7V`?pCUTexA>yl3DT$?JX7h}x'eLx,If9$xqlstwn9embaJ1L/7S8Q[*680j;FN}BAQo:3[!,2,2,4,2,skip
"$QVn|#\)2+.$i""lcTLo'dmLAW*RskKawEKgW3K",Lkl%_k`=__%G5.B0UT-_.v%l tK}WuUE6dpA14=zXh,2,2,4,2,skip
"$QVn|#\)2+.$i""lcTLo'dmLAW*RskKawEKgW3K",Lkl%_k`=__%G5.B0UT-_.v%l tK}WuUE6dpA14=zXh,3,4,6,2,skip
"$W=hWtefA]NdHR2>`btZS!""mG+UD02#ZB@iwXQ","%u:>b@EL^,`}o.T2v|[W*'a:<w^=4}/oXe@y!WgX}D",3,3,5,2,skip
"$W=hWtefA]NdHR2>`btZS!""mG+UD02#ZB@iwXQ","%u:>b@EL^,`}o.T2v|[W*'a:<w^=4}/oXe@y!WgX}D",4,5,4,-1,reset
$a4b'_{ZcA?TNt7`=5F+>j1F5Rq=\1C>v)FKa0,Rl06=h['$?Jr~;gCjY'qR92 &:[]%wl) hm_J;E*+A,1,7,9,2,skip
$vTIBIJJdC[1<q-?-`Irr( d.B/r0=<wO)Pi6j,"(R[>h&VQ4&wkrLSBo)1{Uj!n7`|@`X:1+G>D""Qy[z2",1,1,11,10,skip
"$yu;U}Y/mnuOA-yAmoADY.v(\!l*a^<w`e*,h}","WrkF9),$FMmR KG,/*KIDujGZT~tjwCAjX>~^fxVcS",9,4,6,2,skip
"$z_JMTt8ovTj""F$GwR`ub<^vL'`t}lZ,v\bASR",eZVG*M[}Q<n2 ^(3&Mh\*n-(+{i%;%~%ilN^40Ne4J,3,2,4,2,skip
"$z_JMTt8ovTj""F$GwR`ub<^vL'`t}lZ,v\bASR",eZVG*M[}Q<n2 ^(3&Mh\*n-(+{i%;%~%ilN^40Ne4J,5,5,7,2,skip
"%#`s_5GdouqX!R8FkFDX$a,n#A;<Wy ""'RkBai","}jL:,h5Vy""EYE*qulBov!#WR9&n67fm61lgCRLt7P1",3,3,5,2,skip
%CjW-^n*hoN-Lg~&b!}X')_Q<_1^5t@<U}%Oyf,-?pd6b-a;4mQ:Agz5dDU00B{0;V?GGH&RQxiY:yF!C,8,8,10,2,skip
%CjW-^n*hoN-Lg~&b!}X')_Q<_1^5t@<U}%Oyf,-?pd6b-a;4mQ:Agz5dDU00B{0;V?GGH&RQxiY:yF!C,9,10,12,2,skip
%LNL@SvEDbm|Pbfm#SR^cSj.V-t/q%^eYpv[Ty,"#ZuK >UV#/v$OM'Cr,_al1qL(Fl`XjA<:1ajUM]p>\",7,7,9,2,skip
%QuOOF&9_a1-h/?6pQ\xt@LlkZw^h[UVW0pVks,.^KK}CJE8A00u5<5nD/V(/WV*n-8Lggu!}lq![4EYq,1,3,8,5,skip
"%RE_x*RPr;<[%v>>M7""(W*YYHm[Y!5kI$9U7Qk",c!ophax^g+fSf\eo<?QK''r][I*rl_E*7?P2X;K?@[,2,2,4,2,skip
%Rcxg&4gTA2BdBw>a]avi@-aM}pfU<*X_xh)V.,"6fGm7l6q44h8/~viWog@wYn\U8`(I]3\""|""9U?LmTK",5,5,8,3,skip
%Rcxg&4gTA2BdBw>a]avi@-aM}pfU<*X_xh)V.,"6fGm7l6q44h8/~viWog@wYn\U8`(I]3\""|""9U?LmTK",6,8,10,2,skip
%SD@7T>t1VRCfyCCV!O5|PM)2q[*a+=s2tlzs!,W;xCeKU};e5@d+LE}3ac:v!T&=G.'P+nPc\h#D*1$r,2,2,4,2,skip
"%V3Sp(Z,9$gtQQ=M-A>`<a`vw0B[+la[W\""pwX",K1Go@{0iu@6u5(Q&NWpw=&UJ6 Um=W%kdc+X[T9^B!,4,4,6,2,skip
%Z}K-I_|$V_#zQ9kueZ~MQoGjB|ocGKxE2qQ##,"=""+:4ac%55_1e3u-FL2\F1kY@jAQDnUc6+WC3..e|L",2,2,5,3,skip
"%gfuBe7B(y08X@#ng%quF3NpQkS={r,.E{""N'[",HoM.jl4H[HjEKx+s_q>5C8{xP!=6\qWX`@eV!nDF@A,11,11,15,4,skip
"%i/I,gMJ&DNpsy&""2ox$TPI:+cS]Z:)>}iQiJL",4Zal vMF9Nh%BYl/~g%MdxG=Qg+S;a[Dh*?x`F['16,2,2,4,2,skip
"%sPV)WlQ:z.lzP~?.uYbL60X#pPCd+As\,c@!m",?Iivv!d/R?w!8VK>KLU4lPhs!P.lTWfwt# C\^Hwb.,3,3,5,2,skip
"%sPV)WlQ:z.lzP~?.uYbL60X#pPCd+As\,c@!m",?Iivv!d/R?w!8VK>KLU4lPhs!P.lTWfwt# C\^Hwb.,6,7,9,2,skip
"%sPV)WlQ:z.lzP~?.uYbL60X#pPCd+As\,c@!m",?Iivv!d/R?w!8VK>KLU4lPhs!P.lTWfwt# C\^Hwb.,8,10,12,2,skip
"%sPV)WlQ:z.lzP~?.uYbL60X#pPCd+As\,c@!m",?Iivv!d/R?w!8VK>KLU4lPhs!P.lTWfwt# C\^Hwb.,10,13,15,2,skip
%y$#xgQmCPmXmNY 4t'SP>Yl\eXSY<dY6:L_GL,"RpE:'M10V4({xn2$nX0hCtxd]Ow~=;\h=x0z?j""gW{",2,2,4,2,skip
"%z?Y,Ofd9kN[U'#17iy$}CwmL5XpVt.B-G&#4C","v`#;Wo5dSS3S6/Eh(/!F,`*f(Vm$Kg RkG#3'pE""%K",6,6,8,2,skip
"&'8B|mi$X+dykNDsY4y.sAq\,bW]y-Z1Ak=_g4",}#|F3;q)5jkGxsaXJyi.~?;9QMhF;HFM3l#?zX\Kk:,10,11,13,2,skip
"&0f2\=8;%0w@/|y\#m4aPZK_7}sCn&M]_uK""(4","""\zLB*gK+)2_<`o4]\.VH8`vB!TQgU4NI5J}AFVI!i",4,4,6,2,skip
"&0f2\=8;%0w@/|y\#m4aPZK_7}sCn&M]_uK""(4","""\zLB*gK+)2_<`o4]\.VH8`vB!TQgU4NI5J}AFVI!i",9,8,10,2,skip
"&0f2\=8;%0w@/|y\#m4aPZK_7}sCn&M]_uK""(4","""\zLB*gK+)2_<`o4]\.VH8`vB!TQgU4NI5J}AFVI!i",11,11,13,2,skip
"&57:_(tR{""DTJNjF#T.3I}C^uN7*XWZPsmQ6nl","&C>K5I:~aM](2ajioK,Jp,GU ICmUw&pm65ha2aQ3c",5,5,7,2,skip
"&D!b4g>6w""rIs8w 4GR*4E]PRnV)lSxjsKQ>sn",=?'nZuzIgV`i7|[<OYCjyiLnrW9*'6ybHjSmXijsWA,5,5,7,2,skip
&JG)a/_ir[X3.LIqHbI<03}^RZ.h5Iww|PL xF,]BF3]j=mrDEQ|ChQ?BXPv|;4UF>(:s'1M_M?n;$Wk&,16,12,14,2,skip
&Q5bLZ&lXL!bX>.6a-GU.zx6viLatu:fM3MybM,B:'/h4T%a(?G -rSbE$/>A39[R0ZKsZ6#0[ |g&?'P,2,2,4,2,skip
&mo09-9Y*Av0FUoo&dCOE'k3W((Qq~\h$A%I;=,#Fx1g)b7lF6V'%gJn^xH?22Kb|o0?=#U:h9Ja0$i=A,3,3,10,7,skip
"&nS$@bExju/KrM)BC""&Z0F4BIQ>[C?Ll18OzCH","Auy=VUhAA@(""dX^!*2@N(pyP`ETU\2d-5OD8(Kym8Y",5,5,8,3,skip
&s+9A7}E`DMNp8jC&$Qve<?/?:Ckw^&F);znDf,"!b_5Kk{2\3wq3*7Qu2+PI[Qg%d:7i}P, ]NA9qq2]:",9,9,11,2,skip
&s+9A7}E`DMNp8jC&$Qve<?/?:Ckw^&F);znDf,"!b_5Kk{2\3wq3*7Qu2+PI[Qg%d:7i}P, ]NA9qq2]:",18,19,21,2,skip
"'""3wvmJ`S2K`z|C'#V;2bBl[FP5=2*5qH Rd/N",}nw(nCRFg7r\5@y>y-G1qUPfl2f w ((A/];lmfB1i,4,4,6,2,skip
"'*""Sks5^~34V^[eR<&g[[Fg[ckmPd)UE:z\PI:",X1O6JS*@gO=N:miDy/$!=KEArj[L*$/=vd*PXTs5>=,3,3,5,2,skip
'*~1)}7/iBZfARm\bNfEu``rMH$C;xwf/ar(9k,+.?#3$\bvSG7GIW.{W_A2mb\Vts@0$$2Dx6]2m{U4X,4,7,9,2,skip
'4~}WEr!-*vhXa{*_gvE 4*fFq3fnZ.&$J.Rh^,-[hEUg]roYiE[`(PB=C<Fh}AX5zIXa:nqakk@E1xBd,3,3,5,2,skip
'Akj&Owgw;qg?rq>p7<0bB1(VpBh~c@1W7YE(d,"Q+CgYnjK(/UHoAwDayhT,dW$3,Xg7v|!!&{`V6+U_[",2,2,4,2,skip
'D1);R)qE?PX*\l>eye9R9 0U\OX~v$[}S[|54,"JEl-J_m`FDeY<ht.(j:H+1)yaZ8!eZzm>P&-"">.pF8",4,4,6,2,skip
"'J2E4pJ4fquIg3*1Fays!&`p~b0!M2`*{syV""*","#rMJL.HP%i_mk<<h;FdPC`Z$6?""n/>Nz4_#Z6+4sHF",4,4,6,2,skip
"'J2E4pJ4fquIg3*1Fays!&`p~b0!M2`*{syV""*","#rMJL.HP%i_mk<<h;FdPC`Z$6?""n/>Nz4_#Z6+4sHF",5,6,8,2,skip
"'](}hx|/X^UM']R(+z!Ix?i]c17,8(yiX1x.9[",Xzow7m@0q2+}PGKbO]=.ekIeXAf_3D#?A>m;*4/]GD,2,2,4,2,skip
"'](}hx|/X^UM']R(+z!Ix?i]c17,8(yiX1x.9[",Xzow7m@0q2+}PGKbO]=.ekIeXAf_3D#?A>m;*4/]GD,3,4,3,-1,reset
"'](}hx|/X^UM']R(+z!Ix?i]c17,8(yiX1x.9[",Xzow7m@0q2+}PGKbO]=.ekIeXAf_3D#?A>m;*4/]GD,4,3,5,2,skip
'gSvW!Lz{9IvB&WZ[@aJ49N0?M)nY?@w&r[Ro;,aB/5E79r])8v`!mLwdlZ9Sg7$t0ifzCxf$b[[Z$^[c,4,4,6,2,skip
"(%f:,Ekj#$EuZp?fj!s[3$nEKPylf&-,WqV|<.","ggOhr4;+|W,XOzG(k#FCUl+8P}O7Apw03+<beqlDh2",4,4,6,2,skip
(0!k/x<C!=bP+t:\Gzr!t|auklFMVIo$I\1|eC,"% ZFXCn@L!^/Lf""4""aONI:?oyffpvlvUH(fhKKiLL>",2,2,4,2,skip
"(5VOp?F7tyBUr5EL{=,!uDObSat9VQH[4/>4i+","mtH+>xk^X/GdSYbT3#qX\Nr,OZR1HrT\m8QASEp\G~",5,5,8,3,skip
"(5VOp?F7tyBUr5EL{=,!uDObSat9VQH[4/>4i+","mtH+>xk^X/GdSYbT3#qX\Nr,OZR1HrT\m8QASEp\G~",6,8,6,-2,reset
"(5VOp?F7tyBUr5EL{=,!uDObSat9VQH[4/>4i+","mtH+>xk^X/GdSYbT3#qX\Nr,OZR1HrT\m8QASEp\G~",8,7,9,2,skip
"(@Tcx,qh*=(""'+k:>yCm6+B&]12-n-N$.'t0(w","]oZ(@ZR9/}4ASlT&L*@^#vIa3r""\<EJ{uZ<)n0j)W/",1,2,4,2,skip
"(@Tcx,qh*=(""'+k:>yCm6+B&]12-n-N$.'t0(w","]oZ(@ZR9/}4ASlT&L*@^#vIa3r""\<EJ{uZ<)n0j)W/",4,5,7,2,skip
(GWUpkobrL8ZH[pQ5SjRUBn2+[rJ!D26hqyJd+,"B4|H3`{V[NY[NkCN,rVi1XF""dSih6JVB""gblzHyItj",21,21,23,2,skip
(GWUpkobrL8ZH[pQ5SjRUBn2+[rJ!D26hqyJd+,"B4|H3`{V[NY[NkCN,rVi1XF""dSih6JVB""gblzHyItj",22,23,22,-1,reset
(GWUpkobrL8ZH[pQ5SjRUBn2+[rJ!D26hqyJd+,"B4|H3`{V[NY[NkCN,rVi1XF""dSih6JVB""gblzHyItj",23,22,24,2,skip
(H(n}i8pQL9&v#+tKAfnmM]65 y1h`_?G)HM'+,"TXv""6e}yRGQjwJVpBr!*Wl:&@dzT]>`1a'CYztq8M*",2,2,11,9,skip
"(OHh$TksP!o>&2xPQ#I+twK[eRkBd.Txr?""eg+","BwGRxd2+pMy^vFCD?Y5zd1GL;,:=XkFx0hTwC|5qXE",2,2,4,2,skip
"(RHefDv~>?;c6C8M,""2*9Vt+0""814D!5UPQC{`","?}#@MOk|DwA#i8T|8pqJ0TN!kZfZ]""WE)F2H\&,ES{",1,2,1,-1,reset
"(RHefDv~>?;c6C8M,""2*9Vt+0""814D!5UPQC{`","?}#@MOk|DwA#i8T|8pqJ0TN!kZfZ]""WE)F2H\&,ES{",2,1,3,2,skip
(T>io:2us_+0OFYpK5dm%s(I{*z}@dSI: B\XZ,"y[yE*As%C>,_L<b~\TBa%'R""}3{(nU^vs~N}P$%28\",3,2,4,2,skip
(T>io:2us_+0OFYpK5dm%s(I{*z}@dSI: B\XZ,"y[yE*As%C>,_L<b~\TBa%'R""}3{(nU^vs~N}P$%28\",5,5,7,2,skip
(U%:U|A\\t.Ej'k^ih[8/-Qr1J!JaRCQZWga{b,"-3Y2 gvj{1\#be5XAZ5V2`:gxee0goO@""kfZiau%pf",4,3,5,2,skip
(hJt.>*OER=|;$ @?_f{+jwfvrD6&>n!a&[F.F,Y!BB]/3:8;XOM[wcU$]w:<bfTp'aJfhIbfe1($f[k?,4,4,6,2,skip
(hJt.>*OER=|;$ @?_f{+jwfvrD6&>n!a&[F.F,Y!BB]/3:8;XOM[wcU$]w:<bfTp'aJfhIbfe1($f[k?,7,8,10,2,skip
(hJt.>*OER=|;$ @?_f{+jwfvrD6&>n!a&[F.F,Y!BB]/3:8;XOM[wcU$]w:<bfTp'aJfhIbfe1($f[k?,9,11,13,2,skip
(i[`{Yx{G; Z9iadCX#<ZT{byBmPEy6:Q@mJEw,"]cbP2&+mwOo)^J""qT1_M^$-=SUA,b@D3`Z\kSGiXNb",8,3,2,-1,reset
"(i\TGXc=xd'B2qA7A9Q^MI""E)$pJn?}m@4<V`?","8AK^?r\eLlP,bF(GBEg%1u^1&nGHyU=SP<,).j%wz{",4,4,6,2,skip
"(i\TGXc=xd'B2qA7A9Q^MI""E)$pJn?}m@4<V`?","8AK^?r\eLlP,bF(GBEg%1u^1&nGHyU=SP<,).j%wz{",7,7,9,2,skip
"(i\TGXc=xd'B2qA7A9Q^MI""E)$pJn?}m@4<V`?","8AK^?r\eLlP,bF(GBEg%1u^1&nGHyU=SP<,).j%wz{",10,11,13,2,skip
"(i\TGXc=xd'B2qA7A9Q^MI""E)$pJn?}m@4<V`?","8AK^?r\eLlP,bF(GBEg%1u^1&nGHyU=SP<,).j%wz{",13,15,17,2,skip
(}$!%xas#V!bq_dUe|gPUf;;./:5`%-4p)jg8],tfy*5d\|0S{@Wz#)%+]H$bOmWQtS'Qy&M!hy%MKMKH,3,8,10,2,skip
(}$!%xas#V!bq_dUe|gPUf;;./:5`%-4p)jg8],tfy*5d\|0S{@Wz#)%+]H$bOmWQtS'Qy&M!hy%MKMKH,4,10,13,3,skip
"(~b{ztv*)vCaEB/UVG|Go cjJ8PmtM""Pk@h&1$",#?'DD&--B xR e<RdOcSecb$+nHm?VM!2FpWu#6D9F,11,11,24,13,skip
")-l0_c!!4d~I""lG,B^BR&80$*Zt(3!iaW{.Rd#",mye1KlQNl-4yimS=$rhJ)0 US'+*[(rSgymE).q'qd,1,8,10,2,skip
)4uv:T;(km18j^xCCDAYI=Zqqi^cO5o%xpsn#6,"`Wmp Y>eeyGHuC@|VAP xhbwo8i:ja"",r>#32#8JXT",3,2,4,2,skip
)7}PQ287LHu5jd8\o{dzo;!=i}Z;m8BrLhzD}T,"ldi[)I}Y~twsm?koDci""#6P}D[lmk-k~Jzf&+(e`Vl",2,2,4,2,skip
)9?3kn!{ fxaR[8q4u[F/Zuz`6=DfC3i!*[Om#,"d^j%Djis{5$;8T6f4>]0\gZ[m1SH}xB;J""{W*msOJa",2,2,12,10,skip
)<+kH]i}JYj58sE5(-hk2-tDr}]\iCH>3D|iy ,g[li0(TX\vmdGVJtd<-nb'ndLXo5 LzLidd<r5{z8],2,2,4,2,skip
")<GBE d =/(FeNmVTr6SKYq8,O47{q,G/CD?Q,",FK$!fu{cTWVp2UpYYwX1~WL|VkNpq$e N:DJtn%bbT,2,15,18,3,skip
")=XgToW$;.{,M,PlgEu\hI$N-F$O6r[Mr%+vI`","g`6LafvgLHe!69kRkZgw,Tk14G$Il#.Wksk9uD[k':",2,2,5,3,skip
")DK$v<xyVK6-~TJo*vb%}Y:j=@ ,k+jqstH(m~","u.*gN&P!#**2^M9gYnJT7'An4h%z7;3P0.#]Jz%""cw",2,2,5,3,skip
")PE_?,~.h(-p_$WybLqP',3w<f7}Yl*Y'}1{5G",#)+6blUlC('1$v#@PU5t-4Lunh=:.uCoHA35(j@jM[,2,3,5,2,skip
)Pp6a8{fjvmF;{n&{$pY\YQV:)TU$!`9{wA;<t,`|AWqmcGauvrIz=zNdXj.UrQDS{$gXYM6[^Wh@Xj@h,3,3,5,2,skip
)Pp6a8{fjvmF;{n&{$pY\YQV:)TU$!`9{wA;<t,`|AWqmcGauvrIz=zNdXj.UrQDS{$gXYM6[^Wh@Xj@h,5,6,8,2,skip
)Pp6a8{fjvmF;{n&{$pY\YQV:)TU$!`9{wA;<t,`|AWqmcGauvrIz=zNdXj.UrQDS{$gXYM6[^Wh@Xj@h,8,10,12,2,skip
")d;a#6UwPw""]Tmg>tv6`eHcXYr+CbZk%6|}aOX","l = W2S8L^""dsp:THRy<A2'<sBhi?o\ZN1VO_G}i0]",2,2,4,2,skip
")hl#F]\q""b.'Ov7[YNPUpz>H""2=/ClR`> Y`t ","O<iPzCd0j.^{@GBw)d(0x\c+h@;,3 (q7""lBQ7{mpa",4,4,7,3,skip
)n_b(v._/*:|#)I/>U3s;K7=&wU<o#Cy>sI(%f,"pl?I UrUOk+%Z$R)y=-{ /QVb@(f1wv:p*auo,.%]8",7,7,10,3,skip
)n_b(v._/*:|#)I/>U3s;K7=&wU<o#Cy>sI(%f,"pl?I UrUOk+%Z$R)y=-{ /QVb@(f1wv:p*auo,.%]8",9,11,13,2,skip
)uUs)Zt=!AS?ZGcoE;@icc!>o8/tUv*}i>O`Z),f6E%t{Z{%JdqOsu8K0F+|X)ogZq>@QT)_.x5\5 4|;,5,5,7,2,skip
)uUs)Zt=!AS?ZGcoE;@icc!>o8/tUv*}i>O`Z),f6E%t{Z{%JdqOsu8K0F+|X)ogZq>@QT)_.x5\5 4|;,6,7,9,2,skip
)uUs)Zt=!AS?ZGcoE;@icc!>o8/tUv*}i>O`Z),f6E%t{Z{%JdqOsu8K0F+|X)ogZq>@QT)_.x5\5 4|;,7,9,11,2,skip
*+Gc5+K.`=E#kzBm.d)ALVfn/c#)?m/\n9.agj,""",.$/ICQ#gFS9vV}iUg`9X3b=>F]Vm,;x|/Hd9?:3Z",2,3,5,2,skip
*=%S&p4<Fb4t_[xS`?OB6/Vu02^J' XZmX!2b-,"#Co%U^&:{c""""X nQ.scmIXU{F)~`]_e,g6YdfDr4]J",3,6,8,2,skip
"*T}T90rp})xBILE(:YR-^<'j*6p[6R6~"")!UC{","9G%d4]{d\Q^1g\?BnfOqtZRUG<H ?!.*4_ltdW,KTV",4,4,6,2,skip
"*T}T90rp})xBILE(:YR-^<'j*6p[6R6~"")!UC{","9G%d4]{d\Q^1g\?BnfOqtZRUG<H ?!.*4_ltdW,KTV",5,6,10,4,skip
"*T}T90rp})xBILE(:YR-^<'j*6p[6R6~"")!UC{","9G%d4]{d\Q^1g\?BnfOqtZRUG<H ?!.*4_ltdW,KTV",6,10,15,5,skip
*[Dwu\V)NI7ynBgv'uI{.nf@]5.~$}s+E3$b6j,S%e!vsep yNR%%O0bzwj/.cm!myCr_C5wE\`N{x t_,2,2,4,2,skip
*gf0z21bn>6h)N%ps5cS_~7I~9+t'bkb8rtO3C,"w4L#tfwY0zBM,lJs""OFVtYD=Awa[CHq%G|gD5:!L$M",3,3,5,2,skip
*hn.B%}DRb9wTg qgKOw QK3FFi;Xe#}aI*'Ll,8S:ChETXj;lR}[<:O[7K;Ao'F^96|wY@Ibr[Z]ZpYG,2,2,4,2,skip
*hn.B%}DRb9wTg qgKOw QK3FFi;Xe#}aI*'Ll,8S:ChETXj;lR}[<:O[7K;Ao'F^96|wY@Ibr[Z]ZpYG,3,4,6,2,skip
*pjm!z}}B5r@sIphHDHE1-(Tryrsc<mOEU?>F<,"U""C:>};q4CH~[4 ~?CD""0&|t^`enhx3.V[%7CC$}b=",2,2,5,3,skip
"*{VD?/oBh8Hq=""0rCRdq}/ptCXG&-S`Y<YqzwU","Z!jzUxPQ**';GYAR~gV VoXl)Q6O~%Uau""ey_%L3GL",9,9,12,3,skip
"+$HdAa~YCJ|7#PU3??F8L.S""\#(NS[>L,BrDD:","z))_1gBow""&z6~zp9$Jn_QoJE#aCZtBusrT=!l_GX5",6,3,5,2,skip
+.NJ;UO9iZOeZG8]0{JO#Phc{Ma}![9F :v>Zy,",QSq|>P%EV*#Ecq=,hId-%P,{Sd1yu$WBiCHfQZ^?z",3,3,5,2,skip
+F((MF'lEzOgKT{VvM5o;dA|29ZeGBBjj[-@8f,yTuJD7.Iz*HoL\G+CR)][)gsV5j@HyLP:>?$;U]X:l,5,5,8,3,skip
+F|#T!pni$rAOPQ-wLuDxooDsW=;Am^e4.v-+H,"X+xRl56X&EdXXi/WJTe|x,TkgkK^ T-2l'&P_&n k""",2,2,4,2,skip
+F|#T!pni$rAOPQ-wLuDxooDsW=;Am^e4.v-+H,"X+xRl56X&EdXXi/WJTe|x,TkgkK^ T-2l'&P_&n k""",3,4,6,2,skip
"+KEAbY%?Qx`.H{2(ypoh9P{=Z%]*16f8,:D6S>","`{]%FQLdf7u-*>h,F&*zbz>a~j!i;t{4T[wk0;w#*]",3,2,4,2,skip
"+P%VBr)g,[p>""V+').`m1Yly=EuQX2G=mhgeZ>","TQ\`)j0G|k8|V>j]bN*mTK#4,l$Fh\X:gbEFDnuY}]",3,4,6,2,skip
"+d!lcb+E+H5SXpYA]]Hw 9,VNVRZuHn;r~kYg1","ml5*Le1+g/Bw1""~J9SO)6\a:R@xhfKHQ72>q2snh$0",5,5,7,2,skip
"+d!lcb+E+H5SXpYA]]Hw 9,VNVRZuHn;r~kYg1","ml5*Le1+g/Bw1""~J9SO)6\a:R@xhfKHQ72>q2snh$0",6,7,6,-1,reset
"+d!lcb+E+H5SXpYA]]Hw 9,VNVRZuHn;r~kYg1","ml5*Le1+g/Bw1""~J9SO)6\a:R@xhfKHQ72>q2snh$0",7,6,8,2,skip
"+f?a?$n9y9C(c2u`>`K4T3%""OVAM/eZm*?P7G ","59OP7P2  ?~V3m2{Wv)4ZnL-V,)_RVG:7W~P`B~zw$",2,2,4,2,skip
"+i)j9;8tg&-[_<?E@|@[*,3,LcUByTn,p,,ivb","/?*O,NB=x'Ctc=z8O'[&~&QY^tL3({<,M3<?]J=U+7",6,6,8,2,skip
"+kMXd0YeS'@&b 9trRNBc/DvCV!&:}:?S;eI,Z",grSpF6Hu<Qt~>rXY~`w0eLdEE5T\E\V1dU-^RZ%OpQ,8,7,15,8,skip
"+uG]`{5N#i4>`s2at#Kg5|:zKLIL7IMs,Pm$!:","7,1VqzMKw((NJs7A{7`=kQt4xcAi:pN8/dW(r'aRVZ",1,1,3,2,skip
",!3AFsEH:v9P!n(kqEQ[;^!MARqTe3NzSB).Ha","""""lA!%)^~&i#3X4MlBu=[)u+t1GvPx7@?Pin^y_Z<H",2,2,4,2,skip
",$riJA?TXuvuwxZt1m&me~9@E|+g\>KBX;2{""z",mtBr`#Y9E`3vKXT&&K946qLBO#q.PMwE[yTs~w&@vm,1,1,3,2,skip
",,cgSk~7Bia#2'Mcco{SJS@\C}aKg*P>#.=raG",Oc]4PnyU3FN\g0@D[0I\ZG1D_KPPiwTcXl65RgA=)C,1,1,3,2,skip
",2y06$`V$Z#>*Igo?7m;TaxB&gsR""+?hJ;]2l2","iDbPR5d@Fwn4lH<2+/;u:FUj1H)_-H>Et,*?X2%\[7",1,1,3,2,skip
",PZU;bKH#{uApuPPO>s-Rt?Z%QUI-g68tNn{VS","!ElvII !G83z 9ErRO,_,iiJ,X>4e(Q?`|ys!Ud8!L",3,3,5,2,skip
",VOP)mm%f^4EESvK{]>RNmvYsldF>[gU=L2qdh",_o(e}WAr[y#?lg|'b*/#{AO;9{kQ({C[ YD(tx$t`^,1,1,4,3,skip
",\,z@AK=[h4LR AfR{X4@WOMNj>+|Y{&et]jP4","b_#Eu.&/MI[8)4:WDkm}W?HV-1 $,p?U&. 10L\fq-",1,1,3,2,skip
",`19Lt/(AEpB[i;!g$6_H4^O,?M`9AF_p\+p[)",EU5$.(PP6_&(0}j6+!>B:r:E&ITk[-S-'1U+0idwN$,3,3,6,3,skip
",cRhBq:wkqjG!tDHA&jT*Q@N%Y=0yuuRa8l9{p",5^}/y<%>qpXo!zZI>:C!xL]UMu?_P}Y~B>|+5xY&i\,1,2,4,2,skip
",n$yjrO^z-M]]Q6jg,}1/.q.@yz8g57\FQKfC*","Y'?J%\J\'46{k<vAZza`2J+]e_`OW""bwE`E5^&om -",1,1,4,3,skip
",x0L.v_Oq/8ERC3jPLaH)p,Ntj|Q|.~-GW}7""8","6J1<Y5XRL^)YMb((Z%)xk@T^?pq;|Z7""1>9\kPS3:t",3,2,4,2,skip
",}bA,2udZvs vc2*n\L>Ja|fA+amsx6""21*Z't",L6qb;Ceu>=w>cu3]:r2UKC?Kf}6$e{HY%Fxa%b:8;0,2,2,4,2,skip
-%[h;fN6E32mwf\K&#fZw2Zl.gQb6p[]K0jM/w,"^1""K</:=?nA!^JNC9,+^v/Q[dM6V||=`USc|a+VgDn",10,10,12,2,skip
-%[h;fN6E32mwf\K&#fZw2Zl.gQb6p[]K0jM/w,"^1""K</:=?nA!^JNC9,+^v/Q[dM6V||=`USc|a+VgDn",11,12,11,-1,reset
"-:As[:2^H[.! iym}7@uD?jB*oHD$.DFXq!""Lx","rAF~G-UJao-xUv*wmpMH1?7TR=+Fo =[vspX""ZM[)^",3,2,4,2,skip
"-@I/.:z(u%? *fxF~h!8,/D9`On-UZ/IAuy*OQ",HY%yOvV9'uH^L=aNhNq1KlX6j<#pfJT =x+zAHveK.,1,13,16,3,skip
"-@u9C;|\|Ac,.)$BW)&TK;V""O[6tTgg#x,x>M9",S$Bg]-<4!Ot{ilhb'Hlc$ Vx~C7.e@kQKVN)@VT<l.,14,17,19,2,skip
"-@u9C;|\|Ac,.)$BW)&TK;V""O[6tTgg#x,x>M9",S$Bg]-<4!Ot{ilhb'Hlc$ Vx~C7.e@kQKVN)@VT<l.,15,19,18,-1,reset
-N5gYF&-!y^D)Ic+iI]{{7i1QX _aKr7D|l=<},"~$_Ztjd@4D^0bxTdD}8l2p""/g(L9,q>Mf:\h{%<_SG",2,2,4,2,skip
"-U-*)TX.""'.5>31dC?.%ieg!M:Z=RlG[NT@~""1","#eC`Z~wawj9R\rk+Mui>E}$rcs0;}u`Lio:u""J@(Ca",3,2,4,2,skip
"-U-*)TX.""'.5>31dC?.%ieg!M:Z=RlG[NT@~""1","#eC`Z~wawj9R\rk+Mui>E}$rcs0;}u`Lio:u""J@(Ca",4,4,3,-1,reset
"-maG8J]?JN=X+5T+,e64uNe58(C4Ce'Hv?VJ]d","C;@<p%fb+I|kX?{]uUvwG""KkU""<Y_E: 2wk]`a11gk",1,1,3,2,skip
"-ugKtUSo>,(-$K6=b{)fg$e-(I/aY~+wDy[~d9","Q6D^~u""3ioM^E^6h%vL6oH*Q@qpvG7!7WtG#O!#e&:",1,2,1,-1,reset
"-ugKtUSo>,(-$K6=b{)fg$e-(I/aY~+wDy[~d9","Q6D^~u""3ioM^E^6h%vL6oH*Q@qpvG7!7WtG#O!#e&:",2,1,3,2,skip
-|H`pD657V<}sMT$Ps?#I_@kS6}5;)k7Hu$$De,"&kL&*}""L4i9J/Xx4]^[J3zXN+w<qRZ(eQH~W6p{?~7",2,2,4,2,skip
-|H`pD657V<}sMT$Ps?#I_@kS6}5;)k7Hu$$De,"&kL&*}""L4i9J/Xx4]^[J3zXN+w<qRZ(eQH~W6p{?~7",3,4,6,2,skip
". `LFOn!.p;7jX7w0urNub""_EJ4BwiI9B%l`lG",J1O=}T@Q_5uk2HdeoO=[_Jfq<}Q.y3kp!5DC0`Vz}(,1,1,3,2,skip
".#JIq1x02IeU,\PNbo|u\>?@sj4KcT}C4g%(>L",AxbXz?$gB(`pxM-+Jm;|4UGE/=1O5\`I?BdOMB<p(+,1,2,4,2,skip
.$Wc:Cnw[[?[5pH5[CW^&S-&%*nV$e*E86bhu0,"R|w|w+eL@\5zFEprtsR+)/Og""7kV[K@UGIA7@q>^]l",3,3,5,2,skip
.$Wc:Cnw[[?[5pH5[CW^&S-&%*nV$e*E86bhu0,"R|w|w+eL@\5zFEprtsR+)/Og""7kV[K@UGIA7@q>^]l",4,5,7,2,skip
.'v0oq>T^#`'g3X=bJ3wa/A>V3}=!1E;:K;%C4,"]*mxHbN?""nW*o>fD`L_sn@/UN40n{jz)2q#MDgd0 >",2,2,4,2,skip
.(-eX1_Tp]'E=|i>v7Ri8Ke?)7tVIj-u4C%kA{,vV_ej\+S+]p^V9yRpdeo1KikKU;k?^sw5{0T.v.-]^,2,2,4,2,skip
.-C&ApUlstEoCXq}la2E(ndJjTxf\f@-F6NVau,UaYFEego P].Tn\oQNfeFon6|+Jv@Z4T|~J6Bp0K5J,5,5,7,2,skip
.16*:8:1|>&==U[U_'78/62`XK:{2bpg>y=$o3,"ql+7*""5FraA0W+-7(N""Sjn/5X=ch;.R@SaIOys?{X,",5,3,2,-1,reset
.2U\qAz)unHuS~An\(thUAxZG@9[QV-Ir9[;!M,"w0k/lC!46q+E\4oXG 6.Bg9""v8'm_eq&.Ys`<m)H>X",7,6,8,2,skip
".5([XC]8%H{'18(_,_$yY0b,Xq?&O,m"";60Y6S","M2s!{ib8TopmdVSbPV$By&nXFj8_c!`#&,2^P3,}%-",6,6,10,4,skip
.7{f?7.UgA0v7L_x*bE$I.9jIXg4hk#}2oRHe#,"37wjsx;rjeE,vAdlv:\Mrf0hKk\vRbvd:V~bh#.zI\",2,2,4,2,skip
.AcsE`mw10$>!t^}c!A&#qd-o?Fjh+uJ3c#g+j,"&o,FEOO@>FY2bY|#^B0qJ{]p!)IS7Tmn2 PqY.m$vC",2,2,4,2,skip
.J5W^'!W;Pvw7;@gWvOMA<D*NjZ5958ElA~43<,<Y4d5'_yP|8\r(q#+;1~T/#sK.TBvGEL^8rspx_:4],2,2,4,2,skip
".Upi;Un$nR3l{TDotzb^|( O}Ll,Q7|5H\c:38","6yKM9Tn!fKv+7Rki@w8<,F(dvyr\~0brW>qvC#%7WP",10,5,7,2,skip
".Upi;Un$nR3l{TDotzb^|( O}Ll,Q7|5H\c:38","6yKM9Tn!fKv+7Rki@w8<,F(dvyr\~0brW>qvC#%7WP",11,7,6,-1,reset
".Upi;Un$nR3l{TDotzb^|( O}Ll,Q7|5H\c:38","6yKM9Tn!fKv+7Rki@w8<,F(dvyr\~0brW>qvC#%7WP",13,7,6,-1,reset
".Upi;Un$nR3l{TDotzb^|( O}Ll,Q7|5H\c:38","6yKM9Tn!fKv+7Rki@w8<,F(dvyr\~0brW>qvC#%7WP",14,6,8,2,skip
".VYb~tYyanUk*K,y(p `JTMURp*Ff0{qw?;oA)","4&`%iG>m|vH79r%&gl )~*{<#j`LBt|{,8z)q_ H6i",4,3,5,2,skip
".Z:qd'CE7^""_X6F_uP9E?EZ^uI<}.} ""-ndP7b", :(z];<%]4w^EI8pi@]kg[s!zy*BmSx%#FIQ4s[oJm,4,4,6,2,skip
".\SE/y[;7REHUPaQhw;nA(Js9i&t-5O9M,57\S","_RH|nRfstnU6T&UD|\yxiJ41fT"";`xmv'<6fxsg$Fu",1,1,4,3,skip
".wW/y=MS#gd""92^z6""h>\HC{NE+d'sqb*|A7-=","H^cT v8~#,c\mtGG27n~|+Dy:5Z:\?7I=Hh&9_C0<3",3,4,6,2,skip
".|7YBcZzA/7{.?e6|Q""bb/Q]+`mVd|??IM(H$Z",o1m?3hy{NcI<`VKwJr<c=7|4EnaVs[(]JF!y(5v3T\,1,2,4,2,skip
/!/&#_Qo(K>}hru+dyI7iVaQjj3J/r:HgelBFV,"V0VzNZ^Gb5)'TNYp4z0&}2UkoF0{`I|'*5hOpr""~l-",1,1,3,2,skip
/%Ycjtp^8C?w~j59XL/5.24t2(H#)g)P(uPlX],|5~jW8IXuiE1OAK9tuPe: YW}aQUIXLvawwjF-7)AU,2,2,4,2,skip
/38>je $8f}0Y:<;p>uk.|b1|[ =G10XC;^i+#,ujMrlQ0MTl7;6o9e}<h0]Q5g;l\]#+r59[8MJ#Itfb,1,2,4,2,skip
/A/I_581X[XSi#~%L-UlaX(6j#v8ON+rh@EPht,EZ9Y0_c(0llqTMdw8owBoj.jNuESCbBr?0rZjHbHpC,3,4,6,2,skip
"/Cq+k-}x~FE0_Q^?Cx%St,_3Q;#M2v*9$@cC=3","`WX(220FQ]?ve;he-(f3i{T""TRuG,F$wVa^A{\d?N>",4,4,7,3,skip
/F+3.6!^t%YgWYzYkYL;&3qRz1AHNo<8[C$r1!,R\6 N92rbf~*b*cPC*sV!lz|\'I:`EQ] |^Uh]vhdZ,2,2,7,5,skip
/JH#s07-<zf?l.o*Tc^5PZ9`>#^R<8R3yyVJxn,$)gKL|`prp<NC6p?iFQS1Km7QIT*kE47W(F*J~H.7m,1,2,4,2,skip
"/cGWWHBkW[r_8v,pLF[M?ED1tjX8D`?Z6|TX?f",".JVh0&z&^&GAfVEh&%pOq(94@_+IHY?>yD3jF,\y=s",2,2,4,2,skip
"/{&1=x4^7`H,l7d%LUZBvU}UFoS;^Mc2E4aL`<","8g|c8""Wyo)<W~OF<tWY_sG#34sDjYn>sV,Il]XYErL",2,4,7,3,skip
0$DpR$'~}+63a!hvz{mj->3R+@g^0_9(c6~2jJ,@n/N!p MH%P_9QAmgq4^=TM%sjFVvBfe8fYotWL7m1,2,2,4,2,skip
0Fyi%;#oYayG26 Q o>S)R9QCBC!!K_Z#i<7gf,dDH3!<_`grB<.{<\p9QV7}sA))3q}ulaE<$gz>49}?,3,3,5,2,skip
0Fyi%;#oYayG26 Q o>S)R9QCBC!!K_Z#i<7gf,dDH3!<_`grB<.{<\p9QV7}sA))3q}ulaE<$gz>49}?,6,7,9,2,skip
"0JoD{d_tORD~*t^_VLO,W3,>lP\AK&h`n7Mr\:",FBRG*\ELy?I$#[`R(CG.Q{L]]9YoAN9n#{`iWSP4H$,1,1,6,5,skip
0L;d_b4Y)D<#^_<&T9VN~EfR%1B*uaU %%X]uC,`#z<xhr$~42>V!3owb7OZn`GU{RIS@?}DFXa(o|v&^,2,3,6,3,skip
0]@3q`\*YQ-&?{veOL |Rn:9#50UUJUS$WFd)Z,"![Xug`L%Va^/8#RkYzoRl[^$Zom2#crh_g""1XNV)""g",6,3,5,2,skip
0`mi'70#Tb{tD4>W&-)pk-{%;F[+>I^gqt$n/},=xaTi-`*dH9L~K:c_aT1*PY=<fPAg$Gg*ZT%tFJ(Y},1,3,5,2,skip
"0fM,O?Qms-(Loi6u_dQhgem}q,_lqH{b|6=^K%","MgX}FYuz,-v\ \sHMC9BT4A!6o0ShNym8Z!q|/PCx_",4,3,5,2,skip
"0o""~#}v|=SXq6}Vuy<L&Shs#9rStO;TtR&|']x","1^YA[w1nH{geeev_p,8/PpAv{'Ra@P5YCP=$GjNf>e",2,6,8,2,skip
"0zh$LWS;Hgw)&QEqF;|=a?@EH""8z(7I<y6\ASm","cyv(vph@_PwOMF$ledS&(Pc E""?$4*OE{`i_>""Ko;""",2,2,4,2,skip
1#.^K=$nv{LO%gLIS7@%n{ed}RIw8^eV94Hdi',NKp%q\aeJcmY8H `dQ*wZo?Wy*3~u4&78PN+<}O4aF,3,3,5,2,skip
1.]Tz)Deje9vqZ*%+h.6r&Psuhx4E|{V`KSjdz,384{i2.-`#LM BmWbW2'266Qn$fBJP n&#vxn45~)8,3,3,5,2,skip
1.]Tz)Deje9vqZ*%+h.6r&Psuhx4E|{V`KSjdz,384{i2.-`#LM BmWbW2'266Qn$fBJP n&#vxn45~)8,5,6,8,2,skip
"10$.!12,Yw-$f|ws}8\Zd8P?a6>Z2O*kFs-$pS","-8uc:{?cv,nrc;1X{4`=^SW\.h.d#(k7P!oXQfTVjd",2,2,5,3,skip
16Y:YBq|.NFo#>Wov&n><<\:$Wfo`Nu\><L7EQ,k$c$)G=pr!5P<Mdn9 [n?70Bz l1T$79EC1iCNXE]Z,1,1,7,6,skip
1?<Z.~Q5IGaMc'/()}D@J_Ha8(wl+7%bw9WM+S,"z|x$*Pk5@9(eTZMK=C""l)\6%r;/^hI8yF,^?M\s.2d",2,2,4,2,skip
1@)V?gnNZCW=`O9vhLHo&~rRj3sfcFgqGG_(R$,C&yJ14g:2F]6/8qJ]kGn%m^Tns}cuEDn<k RZypW:g,2,2,4,2,skip
1C=VY02Jo<ejn5W>e4}HxhemOkSjN\*1twTt~%,"5(XR4)#LfSwaohes,d&T>;x]SF:45pOtMKc!m(u98-",4,4,6,2,skip
"1Fl<&rG{gg|w""gFDt{m[."":B<A?zx*bAP%cPQ@",HTLmZP8Wz0yY>Au>(`ZL%dO8bXx_ -LAskNY[7Z6^O,17,16,19,3,skip
"1I30^0pzx)53:<j!p`C@R+r7m_l;d,v""+d[nTI","'}AG$J_jHsn=wBsz`q1qAt;tGhxGvrl@)qN[',Q[H:",3,3,5,2,skip
"1I30^0pzx)53:<j!p`C@R+r7m_l;d,v""+d[nTI","'}AG$J_jHsn=wBsz`q1qAt;tGhxGvrl@)qN[',Q[H:",4,5,7,2,skip
"1^,d{&o,?ep``J(yEx3O{DdQu+-e&=RN+R>foo",SZ_GPH_:lX{.x{LwFH1XJg72t)9)G nL~T2y{-{&8R,3,3,5,2,skip
1i_ye9vu&N 2a\2]p<EuYY~jq3T&+v5M0Ft}eI," p:2.+C|&Zm{6AM%@`cki}RZPm-;K,e44`E""7@eN'I",2,2,4,2,skip
1i_ye9vu&N 2a\2]p<EuYY~jq3T&+v5M0Ft}eI," p:2.+C|&Zm{6AM%@`cki}RZPm-;K,e44`E""7@eN'I",3,4,6,2,skip
1k&^.<b$<4KnB@cop_.}{${}}IA+>hZCK{xh$?,";+`I\|CHlCC4tXhY],r6d.)A>Z<\Pr$$8!olghM{EX",2,2,5,3,skip
"1r5K%:RK:"">r0N](>~|tRs=N z6A_LNOHHoW@0","grBh]30<H}D""a3Coo(AyDLg[8hl~<-RJY!T5@rqRiH",3,3,5,2,skip
"2+),IRT.?b9{M\oM%:""~`e{.3Tayz>-Wp'|F)Z",cp>?[!+/icl~K x;VLMn}gmu9A4y8YGgJ;W^/g[.:g,5,4,6,2,skip
"2+),IRT.?b9{M\oM%:""~`e{.3Tayz>-Wp'|F)Z",cp>?[!+/icl~K x;VLMn}gmu9A4y8YGgJ;W^/g[.:g,6,6,8,2,skip
"2-a%d@x""p$c-X0Zs@~}`GOr*106I),6R3%1Es$",",6l4!nq`i~W>=|s'&AdsAF8i]m1Q=XEX[9Ni`tfMRY",2,2,4,2,skip
"2j;`:{?9'37&},[.7_.kSH>n$4sZ/x{Mt""uKC_",">q,=_-BcY2k0xSs'\k%%F4~?TDRBrj;dk:_ME29r'^",3,2,4,2,skip
2uZ!r-OqDm>Aai+B{UH9xrgzg1*D(]r6Ldb%5/,G5y9ZZ>YhQp*gOqZ]pHLaSo:rx(i{&0|z=qNnDU]+J,1,2,4,2,skip
2uZ!r-OqDm>Aai+B{UH9xrgzg1*D(]r6Ldb%5/,G5y9ZZ>YhQp*gOqZ]pHLaSo:rx(i{&0|z=qNnDU]+J,2,4,6,2,skip
2wJJExIf{!A?z%2uaHGVYmU|g\-C:\x*bYu&{[,GxJ7r|Z/`<_3WF#(![?;mS]-Zg(]W)Mp;xh\o:lzG^,6,5,7,2,skip
"2~;:7d,3UHlD=/Gta&G:uUmMv!:FaG>Q{0$C[l","pbT,s:p`3~\fy;{PI~C(<cM$wM5I"".=E^J(pL<NF-V",3,3,5,2,skip
"30<""7[D[()R$c""`LqQ5^]vY2Git,0@F2}):&Ij","Mbh} q%>b ]@'\OKWkk/6&'OEu|""Rof#LCJa?IPC&$",16,15,17,2,skip
"32%""Q9A]`[]lSCy]L qqD)XA#f%ec`9L4$tW=v","Jrjhv'WIP:Zx!4w8AhZeD4@K62~l?<(@""]*Fr.Ge3r",1,1,3,2,skip
"3[QoS#(0s#7[C$~47ON[7+1B""s<2@WHg:z+*NQ","iC{""=j_C7H6RRxWavs#z""s& rCcUya8'Q;;07S7|%N",2,2,4,2,skip
"3e9_zsCNeNNS""W*0^g9DauOYfhiVv1pmkdKtL]",":Dnc%(n8^u8q?&^SHL'W%\TfX#f@y)""7--Qmqgc8cZ",2,2,4,2,skip
"3u[Dvgj""7@Ok/'So;Tl7!d4Rr+]4w/-MX2P0l&","Y&R3g_*]*l""GEcE-n&SrsV>]>~<Dpxgy./Qz&$B&2d",3,3,5,2,skip
4$T`={74?B qkF-#7;o!^:^J]f=[~sFr$yREft,".o,3f>6jQ4=1lyR_[3*WBHXxicoz#<D.uw3RUe(5Cd",1,1,3,2,skip
4$T`={74?B qkF-#7;o!^:^J]f=[~sFr$yREft,j*{s(8:Yxr1}:N=>Fl)+^ fmhVg94O8i|MMz{(TvH/,2,2,4,2,skip
4*#.>>B~V@O<r0bYwR5%y)#+%/HEJ\$9rz94$h,6XJ+/C[_V2QRh0rlcYH)D5*/wInCTD\miJ&.Bp;)GX,1,1,3,2,skip
4-EggcIp~F$i*@wNop=4q42C?8YDu#9d(Q`<8b,"HFJnA1eW`-sbRk~VkT==b>UBlen""A$w{VH=)t=A1L;",4,4,6,2,skip
"44xs>J#WI0,m1~RpO""#pa!va?%X&ycQTM.caUN",sN(Y+|5;Y~_v$-$rS$#Dx(vhBC$5n?T P~W)VgeOcJ,6,3,5,2,skip
"44xs>J#WI0,m1~RpO""#pa!va?%X&ycQTM.caUN",sN(Y+|5;Y~_v$-$rS$#Dx(vhBC$5n?T P~W)VgeOcJ,15,13,15,2,skip
"4C|adRf)Q'|]2nR?-[^ZAUIZK,Bf:k;Vo[xH@N",",pJi|D5 b3\$PcUNa:~-""A),7%?VE[g<pJ8id:kFq{",2,2,4,2,skip
4T:v?w$g]&Zd&8/7u*!!f:$2[|:9Q5S9>VQ}RQ,"Sm@{%bQ![2m,<>?<|t;)j^f3bRFtiZ'6BP^&x7{|-G",33,31,34,3,skip
4XO)LGuvkZu~%0$FA>H$\W:JZu]6IClph*Urj~,3HxeQ!?_O[mZpES>(;!_Fz^~(WVhL%.)A5TG\$P^nH,1,1,3,2,skip
4Z Lqec xG^!W*v}<qGtK_c`\&KRa!W@{K#_}g,"\QhaOMAy7>k&d}XPee;VrWCc =]O;EpWe?)""+BQkp|",3,3,5,2,skip
"4^K|_Hv-x$wt4I7<lAV,G^fdYwvCJlUWH*--7'","#0S:FT87=?`|0[OfooA,s~z=|s%c5saB\4QKI{1?U<",1,2,4,2,skip
"4^K|_Hv-x$wt4I7<lAV,G^fdYwvCJlUWH*--7'","#0S:FT87=?`|0[OfooA,s~z=|s%c5saB\4QKI{1?U<",5,7,9,2,skip
"4^K|_Hv-x$wt4I7<lAV,G^fdYwvCJlUWH*--7'","#0S:FT87=?`|0[OfooA,s~z=|s%c5saB\4QKI{1?U<",7,10,12,2,skip
4gd?nP%!UiU!/.?m[LT%SIknP1b@uS+:*QJID?,RzQ/;sWsZ' $@h}llu(<s1[j!vps=PBaO6Z_^XuS#$,8,8,10,2,skip
4ry}w7f ~-E#g=[y?LVFg;(!)YR5}k5gdo2 57,"""9KoNuPGO&BxD)L;bkq'L*2Cv[}^1F*C8nj(,w`!>f",2,2,4,2,skip
"5!IPBz:L X7Df 5y>L.|31^N`[yef?nb, c|c-","C)Scmk}@xf0,_#RdweCl]D8({Mx9ILm!:H>jgVO:J?",1,1,3,2,skip
5-%7@sXhD@[73;w=f^_4yhX`sB*EPSe|w-R\W>,"uHhWTB-_0kzg*_LD9+yg$WFlUi,i9dr X-SNmJ[<1J",2,2,8,6,skip
5L7d4wi/(k (#tr{;v0=7VV11vM0>M']%Rb\8S,"\H?v<`,+|xKkKgd@7;3'@3bM""1q)@,'gi`+U,n04_`",2,3,5,2,skip
5O:]os{}/gxxVT&* >vdQX-{oL36Vq8Ej]iw_n,LOQc~07@wcp^p/{v`ZlC9S`3@u5t6&$(7r!KHwh&:>,2,2,4,2,skip
5XJ@ox_VsfNwCQ1WQ]jYR7g%w[\WP>b'+o0w`h,"5CQ; O(""?a]u7U=/1F^cQxngCr96SgX_e@a\i`Nb}-",1,1,3,2,skip
"5XqNA$x2n~<4v>3""o$M=rw@,RzP468RPM{}""Um",&TLpv.L#5PTOj]@36(`S~TG(b*lj1w>aY8rD`-|25J,2,2,4,2,skip
6-aj7sF1hkQP16V`kGUD.n>n{~}<0{-tLk'sU<,"E&gK@;N)/$/Xe &l#v|R""I""\%QhEbQ|NumCV'ik#sD",4,4,6,2,skip
"65wZ?*_#3i1t7l3H%!SgRKO$sHVu$]Az}*?8Q,",[x|3o8\GB:*&c/!E-?om<_}]P4C?FN^`G-qeQv2%'w,7,7,9,2,skip
"6<HC;o<PZxS*ugQIZHm3?V1uOU""GnxBP66fKVW",yRdx\+JR8:!-GPlt-J\GwbeN6MHv83Vj|X?zQUv;L*,1,2,4,2,skip
"6<HC;o<PZxS*ugQIZHm3?V1uOU""GnxBP66fKVW",yRdx\+JR8:!-GPlt-J\GwbeN6MHv83Vj|X?zQUv;L*,2,4,6,2,skip
"6HU?A63v%d85[lnD![\3[.;|,f1(KW?$@cO?%G","/,hQ)/a4704K~D%\B~poq0?s 4?ur[c""quVWMmC*NY",3,3,5,2,skip
"6HU?A63v%d85[lnD![\3[.;|,f1(KW?$@cO?%G","/,hQ)/a4704K~D%\B~poq0?s 4?ur[c""quVWMmC*NY",8,9,11,2,skip
"6HU?A63v%d85[lnD![\3[.;|,f1(KW?$@cO?%G","/,hQ)/a4704K~D%\B~poq0?s 4?ur[c""quVWMmC*NY",10,12,14,2,skip
6KTaxdekCv;Hk4aQgZZ)=&ot#T%)xOsbV8S7D$,`Q|6=E@;lU8*kZ ^2fWExvfnfW(WO 4Ff&5j0?H:<X,2,2,4,2,skip
"6Nm<KWN;9U]GvX}cp*}S:xR)V:""IE$Q<[!alvX",oBe1!p\^N\4@t<|%7\%^;O`9Y6RFf&F%lY/w!Zd\-r,2,2,9,7,skip
"6^mH+<,$/j""w%t}zb58abFAEz)I2]P]I7[h*;5","f^S""N>4.:Ll|*8:7UgWjFt.!(CV@TKH^VS6u,!(+hx",6,26,29,3,skip
"6nbw:gwjXSzy<Se=%aQx@8TUr{^&u[|E(xdf""<",8n6s[$F>ef5[*@~O%3{z&q](X0S9\`K@9=1|j\X$%2,2,2,4,2,skip
"6sv>""}xhs^{)4,Wf@c<YE3_;_Fm@u%8zhb7bO5","SWwHk}ZG3S:$ZeDx.2@cPk1i7A,?I}""P;/pYIMk<0.",3,3,6,3,skip
6|-tG#b#+AiJc;?qeN.1ON$k%4xR~N%$t7Fa-/,"kMd9|Bc4PV=S9u/!L]uV_$""h2U,!Boj^eW0DCjM78t",2,2,5,3,skip
7!_v Bc^@o Vy7z}C/5>eP^Nr(kdOB7NA}g'TN,n47@L[K23%XAU8NKdv$'he%^cs|Lq2<.0 m%X2&_&W,2,2,4,2,skip
7!_v Bc^@o Vy7z}C/5>eP^Nr(kdOB7NA}g'TN,n47@L[K23%XAU8NKdv$'he%^cs|Lq2<.0 m%X2&_&W,3,4,6,2,skip
7!_v Bc^@o Vy7z}C/5>eP^Nr(kdOB7NA}g'TN,n47@L[K23%XAU8NKdv$'he%^cs|Lq2<.0 m%X2&_&W,4,6,8,2,skip
"7;);y@Z_yLL?$d,o\4s}tfs2 L]|`O/(|Qa@,3",{lp+}{<n7~gFaa_W:e=aj1=!Mo83-&NRgF@^18u7#-,2,2,4,2,skip
"7BTbvE?7o^""M?fEdgRE#6CE)aqnLJ{g2nrZ=@1","^|o,CV#]OwBa{#E}&""9(@;K-e|1[XhYnqDImkNPYc@",3,3,6,3,skip
"7BTbvE?7o^""M?fEdgRE#6CE)aqnLJ{g2nrZ=@1","^|o,CV#]OwBa{#E}&""9(@;K-e|1[XhYnqDImkNPYc@",9,11,13,2,skip
7GIRq21Ph9{9Q;t.y(d42H/OJ4V '@;_?`1#8M,"TO%ca:k#""J*NqC>B)60=;U#}E-z.84i&""j^y>fLwe>",4,4,6,2,skip
"7Kx-y=Duc_,(TKfhp)1[PY[Vw\XR ;Ig[';xN%","gS9dZ)q,:!3j#$f21K5D-%B( S{5yG/Oyb,:8xCXTG",10,6,8,2,skip
"7M%%}LE<;UJc,&|lw56y%Wt@1HFycI01H""vr^-","wBkJn`E]f2+gk-n,ZTLBxLO*5rv)|""!Pf{y<vg?zzx",5,4,7,3,skip
"7M%%}LE<;UJc,&|lw56y%Wt@1HFycI01H""vr^-","wBkJn`E]f2+gk-n,ZTLBxLO*5rv)|""!Pf{y<vg?zzx",7,7,12,5,skip
7b_4jLU #U}_BC;[=uk1z.dz k]F VJB:E&2ML,_J2/Jlie$LN!N6))dUxChy|lKW!/]7QC{hdgOjaU/V,3,3,5,2,skip
7oXR4>j'?!u!XTsFcCU&fEH*E]y'9d0'=fO4Zi,iR*9;\8eXyfkklu\&E>^w+OyW^G;R4G{(e)i%of9a&,1,2,4,2,skip
7v9 /neLQ`)eV:r{<E21W1^I{G (rPl7;T 'pr,"^Phx#y=.4yhp62E@TZzvMEYBtn2)Vzl%u*+B2*,4nW",2,2,4,2,skip
7zV&=Vh1tq~_NU'X*%']awiZs)8@+VUV?>{^Lh,%P#HII{m|OOfl34|se+1RZ(xlk;TY<!y^9yiSo8l\G,7,7,9,2,skip
"7{K$Ii$>wu#,M $~n=.'L>y|Nu\n;]Uek*%r_a","p$cC2~_*Vp.1.GyXNt}'+j%[?%F\w$v""CNY/nk(<xs",3,4,7,3,skip
8(\R{6>]:-L}6TOK}[noF'9/9RZyZz7-5`uYcF,")~%{rHg=`2P;,pp)`2)5MrdIcBCyrUO/*FTK""""p}H ",22,22,25,3,skip
82n:jGBF^Rz<fB27Xv6*d#Ik?zUZKCd }d P#M,"YpKP/p,:4<Vad$K%B\hh[w}~ca=K`UVAQ6XZ`$bQkl",4,4,6,2,skip
86[kQg3>5S<@yRM$N qWbCoX%>T$s~^#wTL-!w,o<d?NOKd[`lU8Kww2AYok-o{]R^yQRi$J4Ngw%7Fk?,2,3,5,2,skip
"8:I^xl9n8i<1OzzD%b4Hwngq""+lUtQ:`B4fLN5",7!t1FDIovm `mR]B(@7@`77iGlENNtaZA:{i/2$5|B,2,2,4,2,skip
"8:I^xl9n8i<1OzzD%b4Hwngq""+lUtQ:`B4fLN5",7!t1FDIovm `mR]B(@7@`77iGlENNtaZA:{i/2$5|B,4,5,7,2,skip
"8<q+""..mZcR0j862_:1j+bN<J=(7|d>6JcjaUW",-L 4-!P+>?P:??HzQ=?Sk4<?\orl.woOq'cg-DE@?J,1,3,5,2,skip
"8<q+""..mZcR0j862_:1j+bN<J=(7|d>6JcjaUW",-L 4-!P+>?P:??HzQ=?Sk4<?\orl.woOq'cg-DE@?J,7,10,12,2,skip
"8?}O5GxHqfeX""""ANLPWtxW`ghYzvb<]5UF1JTf",JZh| &[j%8]RRK|JaZSa7&]p\G%V/sKYk6cZcCa/ `,3,2,4,2,skip
8Bz_(D)J:|z}RYw>vGm2d9H>0@a8~F4*eR.;r:,"_HJ""s7h)Mq<~kO1ie""h-[{$/ F>&Kf*`WSLxMlv4m+",3,3,5,2,skip
8Bz_(D)J:|z}RYw>vGm2d9H>0@a8~F4*eR.;r:,"_HJ""s7h)Mq<~kO1ie""h-[{$/ F>&Kf*`WSLxMlv4m+",4,5,4,-1,reset
8Bz_(D)J:|z}RYw>vGm2d9H>0@a8~F4*eR.;r:,"_HJ""s7h)Mq<~kO1ie""h-[{$/ F>&Kf*`WSLxMlv4m+",5,4,6,2,skip
8Bz_(D)J:|z}RYw>vGm2d9H>0@a8~F4*eR.;r:,"_HJ""s7h)Mq<~kO1ie""h-[{$/ F>&Kf*`WSLxMlv4m+",17,11,13,2,skip
8Bz_(D)J:|z}RYw>vGm2d9H>0@a8~F4*eR.;r:,"_HJ""s7h)Mq<~kO1ie""h-[{$/ F>&Kf*`WSLxMlv4m+",18,13,12,-1,reset
8Bz_(D)J:|z}RYw>vGm2d9H>0@a8~F4*eR.;r:,"_HJ""s7h)Mq<~kO1ie""h-[{$/ F>&Kf*`WSLxMlv4m+",19,12,14,2,skip
8E1:/LLz!QpnN3BtS~I5@9Ic%`*W2OV?A0{-W?,"gY\7&:B !F[x;=y2[vs'B^7Zpm;+R`RT{^""5<keytg",5,5,7,2,skip
8Tt9U>G(2lJ9l&:>j|dPjPuaIY!<Oybo7Y9gu),"8 r$y\V2g(LGLPFGq(^,D{)V{<K#MsN`[u,DQ_2}cr",4,4,6,2,skip
8W?GAs(}wQ^s$aC-|6WYBMl.yZtmk_EWi~c|;+,DXZ8T\~>1sjPQ2(ZYn;B;$s}<a^H4:LEX< cpDonSZ,2,2,7,5,skip
8W?GAs(}wQ^s$aC-|6WYBMl.yZtmk_EWi~c|;+,DXZ8T\~>1sjPQ2(ZYn;B;$s}<a^H4:LEX< cpDonSZ,4,8,13,5,skip
8W?GAs(}wQ^s$aC-|6WYBMl.yZtmk_EWi~c|;+,DXZ8T\~>1sjPQ2(ZYn;B;$s}<a^H4:LEX< cpDonSZ,6,14,19,5,skip
8W?GAs(}wQ^s$aC-|6WYBMl.yZtmk_EWi~c|;+,DXZ8T\~>1sjPQ2(ZYn;B;$s}<a^H4:LEX< cpDonSZ,8,20,22,2,skip
"8X:)j=.lA0DLDMwA,OTv$bB>q<>yd-Lk*pMjVE","P{""eTzGvQBw^SuXQ[YN`rmFqn.za,E5_|Dx0w?DB?[",2,2,4,2,skip
"8X:)j=.lA0DLDMwA,OTv$bB>q<>yd-Lk*pMjVE","P{""eTzGvQBw^SuXQ[YN`rmFqn.za,E5_|Dx0w?DB?[",3,4,6,2,skip
8]2HkVbE4nrx)D#C<F'sh9P/R*>Cg:%m>:Z 8q,"j#qEdCrPS.bsf!-eO'm$:IP\cl[OygGW.t_B,K'MW>",1,2,1,-1,reset
8]2HkVbE4nrx)D#C<F'sh9P/R*>Cg:%m>:Z 8q,"j#qEdCrPS.bsf!-eO'm$:IP\cl[OygGW.t_B,K'MW>",2,1,3,2,skip
8]2HkVbE4nrx)D#C<F'sh9P/R*>Cg:%m>:Z 8q,"j#qEdCrPS.bsf!-eO'm$:IP\cl[OygGW.t_B,K'MW>",24,24,26,2,skip
"8aAQ20c_sj#Y[akj|Us)`X,~-j[XcuVs\Ji$)a","B""S)\V]^E33*7)v)_Lx{A7|-2Qu{|axpbhD}p=3t&!",13,10,12,2,skip
8c=?RZ>jK[: P=h5#Y$KJY12jgI'*N+)9~I1+[,7~7zC5^%-:;;Uk2# PH#Fw{M];U$?d[%N)WOHX-ncv,3,3,5,2,skip
8d >>ME6T<TfXn4U7?@x=AlW}ICfkY*f^UvcbL,"tag2SF8ObVbmhnGN^|!,$v3'rqF]5?)`n6k28==#I{",1,1,3,2,skip
8fX7A5Fu[`7y`;])`nWd'd:YwX9JW!LADVS6M|,"%7mJUkTRcv*:y<u~j[S&""e{$AGp|rt6+'rbn5nGM[-",2,5,7,2,skip
8ps8%u[d#.iXE2{m<\b;W*'L4>uwdf?*ki#@\;,"Dbry#L#DaxI0=>F_OK""NgM!:px_Y|Vmkt()eMcB?X3",1,2,4,2,skip
8ps8%u[d#.iXE2{m<\b;W*'L4>uwdf?*ki#@\;,"Dbry#L#DaxI0=>F_OK""NgM!:px_Y|Vmkt()eMcB?X3",2,4,6,2,skip
8ps8%u[d#.iXE2{m<\b;W*'L4>uwdf?*ki#@\;,"Dbry#L#DaxI0=>F_OK""NgM!:px_Y|Vmkt()eMcB?X3",6,9,11,2,skip
"8u>/ECY/63t5G`Qfo!qA*>/%$[*Oa9A,@D}^AD","CmZpRsRE\ OWpiv}U_:K-u6""?glm&KwhLS:%*JKskT",2,2,4,2,skip
"8{o5a6@55'xiO*Fq?/P5e./""~egnQL>161+Q}z","#y7s+K%h%N`6gfhCdgj,zmN8*""r)my09~(j(ocmf~U",1,1,4,3,skip
"8~lG2$JmI<&K6A6`pPgkg3qink7c[j!5\5:f""!","E8)Bc""MiLg4OSqaZzyu+Q!&U@j6H.C,)zgvvK:#xT_",2,4,9,5,skip
"9!ql&5:=}.t,N>s<t CY>vUqlT,Dwvn;9P^[s*",h-(^A_ Ch8`4Mnt@'[C=CS }-J(3-{*Uaj'5=IZr;f,4,4,6,2,skip
9%/%j70*a+`R`gED0Z=uu38DZTLrxZnqdh>^~R,"=>2dpjwvtAB./1LH4LV.d-^?,E$3fDrNiWI'/4i3ol",3,3,5,2,skip
"9/=9QkD[k1`o56#=Sp[9Qz%y,aXabq97SG`A\N","<QXk2BCB8l`B0jo0*3M!""w@7x:K:i""!ng[0ZI8BbEo",1,1,4,3,skip
"9?@iwH.}F""_4$R<*P#Z.Iw][nW]b MS1uBOnG{",Bp2%fn<RK/UiPb.WHbkc;pDdZa#Vm;{2Y(2 ?pvMsd,4,4,6,2,skip
9Qyi-@<j/DT&Uh{+@awf>[uC_.NN9i?BIa}mZ7,jC#.N/n%O1|YJC+sIjf_>g*KQv@bYHAtTsUc($QV6z,3,3,5,2,skip
9T0fj|~\}st ws :$c(k$IOTO?!eVlh'y{mOuR,"v3]T:8O7R@!I}uM1TLr\J8M^]i~7f6U)u4""=!lC1I}",1,1,3,2,skip
"9W)fz\z6sGO<-]~Ey=+tjBbkSj-RHbq,yQP ~x",{jj%u+Ao2kuvt>6{uz7=~JIlqvV1YSLJ-U^J!bt*7k,3,2,4,2,skip
"9W)fz\z6sGO<-]~Ey=+tjBbkSj-RHbq,yQP ~x",{jj%u+Ao2kuvt>6{uz7=~JIlqvV1YSLJ-U^J!bt*7k,9,7,9,2,skip
9Yo@^go7W][zY#I[h|:i|oSXmB&_ I:A zT'mr,"tu*WW}H2gG=9,YH70Var:Mb^-2#nI4dlTD/+O3<`)'",2,2,6,4,skip
"9[,$/IQ*lyhKpZ""p_y}f@)A{><&z%s%d`iq[.I","A=YmifCVUv3;Z2bSKWUQhwShgb5zy""h9&a M},#:5N",2,2,7,5,skip
"9c&:A>~Pp=g>*\&P&FMdi 2bK^S|s""8$d]K im",">""F.!m""@j&ge&8sHTunKn=C|{z^N8P*EY$.FpG=F(S",1,1,3,2,skip
"9e:3""En&eW@R[^$A,wQ@_}VhZy$c<]3r(+#!d4","bCnv^wN U|YN@s""E`{9wVW(?lZ Zu;SienE2>Q\`dS",2,2,5,3,skip
"9e:3""En&eW@R[^$A,wQ@_}VhZy$c<]3r(+#!d4","bCnv^wN U|YN@s""E`{9wVW(?lZ Zu;SienE2>Q\`dS",3,5,7,2,skip
9ioXL|qf*?Yg13z}A1)`9O/Y2_&RQWbRw=pa0h,)CI2Df^DA:BL?p\;NAonp -d-tsfIreW>MkD$RG4}l,4,4,7,3,skip
9lfj+n:\J\8NTE+&HpZ]b*&!`2yV+$FvH<<]c?,",.<HxX%as#`)?pZ)x?rg.=DZrUFTz|6)&L|=kUmf$r",7,7,9,2,skip
"9ou91g`<w,(u^TPu;;2(-z|3gR! |wWW\W}vaS","C.PfNT6H$R$h!JTI3bE0zvnWjNb,cBx;c5RP{$~!0L",1,1,3,2,skip
"9vDi>/{`{Xb}""E@mD\&a5m?UZ2|3{p^brgS8>0","|?WIG*9H{KM3/xp,mq7sIBfn-)[=L~jo;Vf2uutic3",1,1,4,3,skip
:$J9q0\z@Emjmg[hu.%zXK~h^0rAT(&(@4?:0I,"Qj$KJ^/1~4d`}b,onCovS^=_|^\fJjKP^v)g&`Jf2X",4,4,8,4,skip
":.`L*;eIEVI?YG9(9&pu)R+f5~b""5'{$}yz1yn","#mnWcWZz~sEj!!UWN+ne%3O0Cyj.""m#4^(<>du<G|:",4,3,5,2,skip
":1'ebj'6l6rt""u-*nY^$9vwJq9*V5#GuC&Q8v_",uY&&r~s.T/qM)k?iHo]Y~`g1wGZyZL3$HxZ.3F_&D+,2,3,5,2,skip
":1'ebj'6l6rt""u-*nY^$9vwJq9*V5#GuC&Q8v_",uY&&r~s.T/qM)k?iHo]Y~`g1wGZyZL3$HxZ.3F_&D+,3,5,7,2,skip
":1'ebj'6l6rt""u-*nY^$9vwJq9*V5#GuC&Q8v_",uY&&r~s.T/qM)k?iHo]Y~`g1wGZyZL3$HxZ.3F_&D+,4,7,9,2,skip
:22LNLo )=1J/C]?R#Kjg#.@-];j]%EBYUPXb%,"*5Mb~69in(""k-M2fIKh d]}&;Dux}[d#-S0?e%}DK.",2,2,4,2,skip
"::a2V{)h^dpwYGi)&""{GVhSXPgrle).RK_]mOz",A2z8X^~yfPlM`hHiHjEMC_vpBkN7d;L:_`r0l8bX q,1,1,3,2,skip
":H? WFb&0lZ>.A=]~dQE>5+n=9y4Ei8?M`""[sw",rnbO\;[>DNYXJq1p1I!&uc*.\?ir:[uXifzsgGEQl>,4,2,4,2,skip
:KuDvPdi[h[\2oK=t{4EHaE~75G1xX7#]zpm?F,p.g[E[]o!+Mv\SU 8S9BuG9*mZ*XGCv'XnlUu3H/b(,2,2,4,2,skip
":LoY(4-BzGBl>q!,rSA:%y:j3y|=&aky;,~TrF","%q2Sr_i""hXMXgEVK_hQ!kGaC1QiJK[m40Q)aR_m}_A",2,2,4,2,skip
":Pe,5YWy!I*JjimlJ%IG.9'4%Gqs(""c:@wk5hb",Zr1WyT[l0{^pp8Q`6(/SkV%5i&}bjS8O9z8VWGO26D,1,5,7,2,skip
:VRi3A6?UW$FLUo_=8c%+%AA4HHYupnvqF`W6k,"<GA(^u=2<rreMtQu}=daK1`&Yc1~hXN{o?-`NUl,/=",2,2,4,2,skip
:VUkahzq$!rq(1Ez'U%BAvl{xcq7O_cI].z~vq,"^fkNuj$Kur&Eb|? oy8@U f3(A)& A,!ZYZIC7%Jm$",1,1,3,2,skip
:\miK9q'O5`ZzKNdh6bo%1$4Xl1V5VV=`;i>)C,"xGxzJIN5%0`F-B,br&_KucN;usZdPARU;*}.Y&#oOz",2,2,4,2,skip
:n05G+k}8!)z<]5t~mpXr[Yzhj}(1qvqel)U;g,Pyr!vJ<srGS5}_\)iVKJsy=Q@@bs#}ldDQeO6b n}.,1,2,4,2,skip
":sA\Ppo"",\Tp\ALIG$rlNIHrL2<~JIb)#>j+m-",?jy'N&_q^A`5nz:4oRp6r~tc)V{?)TRjn7wu>s]VC#,2,2,4,2,skip
:zt>p564z3}'h!>Z5JH{o2d&Hlc}~HXxcgV*A5,81elbTL1)3u^c4fzXoK_'rzb_Ud[AcbUPqf:S9r- ;,2,2,4,2,skip
:|ri63jNoM7/4b/).lgq@-P!}Pmb4^cQi'IOe#,"dhwYJsiTw""*>R0<^85,EDhJWgE84_%<ZK/l(JzIIBQ",3,2,4,2,skip
":}Y<`2:T)fxxB_6en*}kQ^rQbN}(}/[kxxJqA""","Akes&6]p)e<BdA261ViuUBa""h$n""/z;v)dTC1?@199",8,4,6,2,skip
":}^dA8`I7I.$aS|@SE]]zHi^TW>]O04;y>Sv@,",JS[C_C+V@Wc 13Yxc-%j_LM~ud`#L[0zCRB.O5v5Mo,1,1,3,2,skip
;%i.E3LKd1d {GOh&Aoh!L^0MdM)^:/lWvbc~=,"i{rR03N>w9|v!@)!|}(/K1u5w{K3tYfVWxxQr""R d-",1,1,3,2,skip
";-)`.SLmH<r)JX=O9t}3@Y}""f^*|YLf4d8bm$G",KSipW+>GEAtTdD;PWy~haRnQSnmZ@ADh5l5G4`TQe-,1,1,3,2,skip
";-)`.SLmH<r)JX=O9t}3@Y}""f^*|YLf4d8bm$G",KSipW+>GEAtTdD;PWy~haRnQSnmZ@ADh5l5G4`TQe-,2,3,2,-1,reset
";4_#4<e9g;sr!ek/5!iLe.sc|T@',6j:Ifo8_\","8qTKM 0:lR^x'zs4?L|@5h{ePrj=$w]gL1L-""|b;^2",2,2,5,3,skip
";4_#4<e9g;sr!ek/5!iLe.sc|T@',6j:Ifo8_\","8qTKM 0:lR^x'zs4?L|@5h{ePrj=$w]gL1L-""|b;^2",4,6,10,4,skip
";;NYX~zCR}+;`N\:,FKsxP~[!r#/""~nH~6e*$E","b[1W!.K:B7)1g}{0[qr5;\gPk0fsaq:=DuyjLk""4fd",2,2,4,2,skip
";@?=m8m+U""80bhX""t43,r<\+ZB_$C|6u$p_hoO","n45Q2O#H6jl/pARF.m,R8}l<o<>mL`TQ3>ELN{FFqL",11,9,11,2,skip
;PZi(@d2n-p6(K:1>Rs'=]h)psdD6C=rOMM{T],r}:@dosBHO 2P:8!r3:j-N_n70BHP*%0zst.An|SNv,2,2,4,2,skip
;Z?>DRF2q5ji1C5BBoF`3P%x[[pnft^E[2;aP(,P%!q!:{(QX!;Q3tyv-Ja+@vOXoqa{?CL[9uiMD~gpN,3,3,6,3,skip
;olfwweU98@0-KT'qO0Jgq\Dxl1@HUlZp}%F-g,"=HcN.lmI$8c""2JP0#t1r\xd{ex0A#:LsPTugm0rAT)",3,3,5,2,skip
<!NtbhM_$v^veL<bPS3:0ryKk0rB$Edi*`<efJ,"ZaaP|^C?q16l%UQ2})o5""z9|HUwd)?GCgC=xK|:x{g",2,2,4,2,skip
"<#8a77[!`_-6)@yD2B+,lv_gQ-Y;QG28FL(h, ","u()}^=v`nWNbT#fRo7cCb+M:To*Rmr9]""3[bl2m)%`",3,2,4,2,skip
<*.5K$Kz9>({JUDd!-:HiL'(D;T) b+ea.}ao9,s/@h*l#(>:Q^Bu9;';{6&81G$Z8^r8TVLi`):Y#{4w,2,2,4,2,skip
"<,_=@XbO4CWu@av@Vf<0l#M{e&$&D+vPjxQXgH",#_f&fb=u\nYSD\;%+NV2p-(\vYFU^*G?{5M+k9l\)[,2,2,4,2,skip
"<,_=@XbO4CWu@av@Vf<0l#M{e&$&D+vPjxQXgH",#_f&fb=u\nYSD\;%+NV2p-(\vYFU^*G?{5M+k9l\)[,5,6,8,2,skip
"<b|w+mF>O_^lgNqja6`$b8B&ANZ>I.?,%LXe:/","$=6lEau|JbL(tWGtg8xXPBo#([!#)cz""8cL249vN&w",4,4,6,2,skip
"<b|w+mF>O_^lgNqja6`$b8B&ANZ>I.?,%LXe:/","$=6lEau|JbL(tWGtg8xXPBo#([!#)cz""8cL249vN&w",5,6,5,-1,reset
"<tP_SF05f)RY:""}LeYr#B{t_i6vn{= St0r]Lv","q781Y8?'&pvh0)E""uCIXj;kJ-jRDlaiq<?`J!s!_YK",1,1,4,3,skip
"=%V(lA-;lK_]3/:-j=c{>ZAB""8L*l&6H/7qVKa",sL2Ca#hP}(e#5Uf@4xzb^(y>p/.fl6O4(e/_MA<Tb*,5,5,7,2,skip
=(a.x_h^k2<*PHkpTwNf+Y1.y'qoKtJzG Puhg,T\EM!M(Xt8Yz/?qNQ^wWkw}kxbvI^<Ml46a #p>9cX,1,2,4,2,skip
"=/$geH]]""3NT~9>GwfACPd'$SF3\bC*MG2rq~k","niU7@_K0,izwg(D$:u$vVK-Vt6n1:j:p'Kk tF5BZE",4,4,7,3,skip
=3X.?zH MG hD.DW3ZD'ra$ic!NUQrfrDlxTM0,"G9SCH*Eh*wB?H8 aWM98{rX{jWks#+']wG,#a,I;J>",4,4,6,2,skip
=3X.?zH MG hD.DW3ZD'ra$ic!NUQrfrDlxTM0,"G9SCH*Eh*wB?H8 aWM98{rX{jWks#+']wG,#a,I;J>",7,8,10,2,skip
=3X.?zH MG hD.DW3ZD'ra$ic!NUQrfrDlxTM0,"G9SCH*Eh*wB?H8 aWM98{rX{jWks#+']wG,#a,I;J>",14,16,18,2,skip
"=7fS1iEZkzZ+\1(G'ZKl1d*`7K""'x+9j\9_{sG","w~G^qT_0,80Es;H[wajLpu1MMm@7uPJZ)!fMY/V#Dt",5,3,5,2,skip
=;b)e&I.u/Gq9}{f769)xN(dc.=HQ::ofAM*wt,?5rT{-:pB%mzf3O2!x!h\~4^9Vg$52>6$70BJC~va+,7,7,9,2,skip
=;b)e&I.u/Gq9}{f769)xN(dc.=HQ::ofAM*wt,?5rT{-:pB%mzf3O2!x!h\~4^9Vg$52>6$70BJC~va+,8,9,8,-1,reset
==U-Ls3AAd12it#.1%eQ_)X/YV_M4-Z0[9B8}M,"p/\6t8S UR~\,bAn;|$}t_u(lz{d5E:5 fsp*{xa$:",4,4,6,2,skip
=LCA|DV_]8M$Bdd.8;22XpQ BxueZ-8Zbv<suj,lhU5*W43*z'6'aD:E DWu2HmA^OqTr^cj)gHFvNL%C,10,6,8,2,skip
=LCA|DV_]8M$Bdd.8;22XpQ BxueZ-8Zbv<suj,lhU5*W43*z'6'aD:E DWu2HmA^OqTr^cj)gHFvNL%C,11,8,7,-1,reset
"=[""j5v1Yg+<pYJ R!nqEpbR&`!%r)Xgy1_=gw|","&?]+=:AC(e*97yQ&\6=`M`JsSC?w;L1n,8J(|%OuZ;",2,2,4,2,skip
"=]B""sW52[&M~aV,_FE\<q%Y6d('j!g62h)='M'","!ew:blOS %5.%[ov^}'V&=)<nu7i(IW0>""D)?:Te[|",2,2,7,5,skip
"=a""kUFH~<;`wj[j!JG\T{_=1SE}y9\ l8y?=r|","\S`_qA-GR_8&k!O%@N?7q%z88$$sh<a)^yW,5rW!/S",1,1,4,3,skip
"=a""kUFH~<;`wj[j!JG\T{_=1SE}y9\ l8y?=r|","\S`_qA-GR_8&k!O%@N?7q%z88$$sh<a)^yW,5rW!/S",4,6,9,3,skip
"=gs-JRLwK%UzRZA~'vLbr}h~_)""nL]O31oJk<a",";MW[nl.QR'(<n&!zr:<!u9xorhS@wuc\~,Y?_KoV4r",3,3,5,2,skip
"=zZ<x5+vC!.,-`D6'ne;I@2N%f%_ROH$Z9w|A9","MGY#.o2)Wldrg,Zj8f3!{k0p'0pMzfb~uydP689M$N",7,3,5,2,skip
">"",C^Pp3_{rWAw/Ocnywuw^7C9<nLi^ix>BmSW","{a^YTG@p]@a68C/9_2:m=v<,z-l)tnrQ& =&9D@3}Q",4,4,6,2,skip
>$L/9E57N0jx6U$WzFYE' m)As{}5ir p;:qO{,$^5G5eZ>N'K4$dt[lp.(*/)!xhV\PUD5z*R@7Y&B30,4,5,7,2,skip
>$t7C[s?9^hMAb)Id:ckn+p /lE{Ny:Qs@6)55,"~J0dQ!>P22e0EsI_""QHgmg{P]JQLFu.V3jJAmoPu{?",10,5,4,-1,reset
">&sJu-E4 W);KM9Ut N%zV""6n)2YC>ji']30n0","5EU,jX#U<r:~qn>l]o7N]Djc-.2?*Ccfnpu{X:>_-/",3,3,5,2,skip
">&sJu-E4 W);KM9Ut N%zV""6n)2YC>ji']30n0","5EU,jX#U<r:~qn>l]o7N]Djc-.2?*Ccfnpu{X:>_-/",4,5,4,-1,reset
">&sJu-E4 W);KM9Ut N%zV""6n)2YC>ji']30n0","5EU,jX#U<r:~qn>l]o7N]Djc-.2?*Ccfnpu{X:>_-/",5,4,6,2,skip
>'n#^dB`iXz:!`v+ @gUxDM|dNg +P~zfA/aus,"JDXel{<nk.pU)d]o7QlXHO*Y})i""md8$7=SK]Yq~7)",2,4,6,2,skip
">,DxJ\KaCWUF~YZJ=BFGvVo]v]yR[X!Lh%ICBv",o\H=8VvsXMhQ 4*$]kr2_M]>W-X8`P/Wa]oZj~5tHP,3,3,5,2,skip
">/ap=slqS@FqDza,Y:9DBw0#{,W< C0*Zs/FMg","o8}RWG.w*BXg?*K/,<(${gd.;by@}GoRrQsZiIN#=u",5,5,7,2,skip
">/ap=slqS@FqDza,Y:9DBw0#{,W< C0*Zs/FMg","o8}RWG.w*BXg?*K/,<(${gd.;by@}GoRrQsZiIN#=u",6,7,6,-1,reset
>AjHW}Y!ObAF$ghqe!{DR227{^OHJ-!uOlTj\),"i1f 3E>;uoZlzva(-BktGPxsiuMv1vPq&C),_#\5(>",2,2,4,2,skip
">h*7Fgt=_t_=,JLb0P+4|$br~tr/g?@l>GV\6m",2>{.eQMi;y)!!_#bGs-)(|%0JyZ1Yq}\ A7AAvi:LO,2,2,4,2,skip
">l5onWHi_Xpv3*uk`|&5fI=,neq`8xgfx/*Y3W",[JZ<M$QiiA^UeL$jS&(m{=.o1_QN-e\Q:ubO|!rgYl,2,2,4,2,skip
">rYOP+rD}Q,Z*`32zJbeM'/I%AULWa}Ym}?FsI","T]6 ht$.C%gD4{Ql._|P3v6E,2ys{:x6TPg:_81oKz",4,4,6,2,skip
>ry%AZ:nd.*(!5.+I5oH;$#-\7\YsQWyPBup@:,"{v{6oH;d2S9yNRu8LV+pHZ>^,""]+\@hdwU$""le;NT7",1,2,4,2,skip
">wk!]jEQ_P=A22Ca?5`z_}/6W{mCP=/7<9b""9v",s!l;f2=6bX.o4rDfmJOM:VibBWMu;:#;>3&g-Ti1?},2,2,4,2,skip
">|\m=<$C~\;/[p$,H\X4~BRY~1JaiB>Li1 hP,",MZtHS2n6Q_03qoZ7'a=ub'WU6_Rwa$HoffTm0g`&b-,3,3,5,2,skip
">|\m=<$C~\;/[p$,H\X4~BRY~1JaiB>Li1 hP,",MZtHS2n6Q_03qoZ7'a=ub'WU6_Rwa$HoffTm0g`&b-,4,5,7,2,skip
?#BHN6<C1!2F:d#Pqzb!xq~B?6v+hFS^$d_TFu,F*#%`[`*DF$0Qn+5w_3'XC5W@Wd3nl9f^_oX!G)/UM,3,2,4,2,skip
?#BHN6<C1!2F:d#Pqzb!xq~B?6v+hFS^$d_TFu,F*#%`[`*DF$0Qn+5w_3'XC5W@Wd3nl9f^_oX!G)/UM,4,4,3,-1,reset
?#BHN6<C1!2F:d#Pqzb!xq~B?6v+hFS^$d_TFu,F*#%`[`*DF$0Qn+5w_3'XC5W@Wd3nl9f^_oX!G)/UM,5,3,5,2,skip
"?&W<425!&XsL2Y26Kl:AIv7GvT>'?Q,9x,8[JR","1tLBHU6_I=w`LMUt-ZOy`-h/lxrnG0T(:,Ng[Tr=sT",1,2,1,-1,reset
?B&bK'ob-V6@Xyp\3YQJd\Ru|tWxojgcRfbSZC,SA: %/)EPMWo(B>\8xpPTMEVO|e6o\]2L|ZT# L{[m,2,2,4,2,skip
?I<8MX![Zq=eIX^vf&H^^F5p5p$SH!v^A! k~u,"K""!JhB}Da5Im~ivJihv0:w1^I&S3Q/Lo+9u0vU9+i,",1,1,3,2,skip
"?[{RBUbA=$&Wti""<EnsSaSa#)fB\\gV$:c~)~A","-%,zL~]9"",h<g`wPTr8'K@[rx*a:)V>!wq=X('cqd{",4,4,6,2,skip
?j7G(=43:heO/~Pm)%1NvaE5GCp3$}EQ5x)6gQ,"crdasJcw{YbQ9rTT1Rxv<?=|t'#,4nnNP3NQ2RmO1&",4,2,4,2,skip
?j7G(=43:heO/~Pm)%1NvaE5GCp3$}EQ5x)6gQ,"crdasJcw{YbQ9rTT1Rxv<?=|t'#,4nnNP3NQ2RmO1&",5,4,6,2,skip
?j7G(=43:heO/~Pm)%1NvaE5GCp3$}EQ5x)6gQ,"crdasJcw{YbQ9rTT1Rxv<?=|t'#,4nnNP3NQ2RmO1&",6,6,8,2,skip
?j7G(=43:heO/~Pm)%1NvaE5GCp3$}EQ5x)6gQ,"crdasJcw{YbQ9rTT1Rxv<?=|t'#,4nnNP3NQ2RmO1&",11,12,14,2,skip
?j7G(=43:heO/~Pm)%1NvaE5GCp3$}EQ5x)6gQ,"crdasJcw{YbQ9rTT1Rxv<?=|t'#,4nnNP3NQ2RmO1&",14,16,18,2,skip
?lDwk4 /\N%(}!r1T$\CS-u9yN8LjK&S`h[yaW,"*7]_,9?KG%~F=wA;^m\e`?3G0(c]r/kA.vL""/nqMYY",2,2,4,2,skip
?lDwk4 /\N%(}!r1T$\CS-u9yN8LjK&S`h[yaW,"*7]_,9?KG%~F=wA;^m\e`?3G0(c]r/kA.vL""/nqMYY",3,4,6,2,skip
?on X*>wBt+j-H&wU]__!I*z!f!ec|n#vJbRO<,"N""X>b['VMG?$kc2y4TAX?u~#{`:%-'xy.q) ed5C[/",3,2,4,2,skip
?p?fV?1wE&*~\g}4 ~bmX@|NQh'N7Y__E%B|{+,"C.]VrHNg#O""ofP92GihE:,E=.[%C#3w0t~BKIL{ d4",3,2,4,2,skip
?wp_Bf)SieUqZ022]>@]dv*Q{*h &4 <(/7_:o,"Y2wn2"">1 q\c8v}[jR~a77avODGt`Au@prode(do7!",3,3,5,2,skip
"@6IhAjr:>y] i49sD-iWb5j,_hX051Ta,l8R3]",/ViQ$y3f3>RkX4xj&]?v{i!s>3)nCLR*fx4f]OdVs0,1,1,3,2,skip
@8HTP[/q:msZ&0m:`IA>DoQOJ~0O)phhyAc S2,"r5%4oXVJNFMJe|&""BCS8]""xW>z=sxc1H2\)>vTg#*R",1,2,5,3,skip
@<)>x*M<q)QI/wNE%r0bh\%Ch:&.ver$B>GYk:,`K_D5GAA'u#7KXSFosQmJb24z0)mI#^[4r.~od+^n],4,4,6,2,skip
@Z)x+{}r*rV)G@u{! uzRHmZtBdtAkH9@n/FE},"s=ky@""mG11)bEA'B KXp[b[.~!P^^sFq[P&. DlU2X",1,2,4,2,skip
@Z)x+{}r*rV)G@u{! uzRHmZtBdtAkH9@n/FE},"s=ky@""mG11)bEA'B KXp[b[.~!P^^sFq[P&. DlU2X",2,4,6,2,skip
@]KbI]>3@^`:rKWk\cX+rwMpXUPT@Yt2('SlIy,HQn$W[qyJ)-gWC-J-jk4(gVYEwh^%OF>\wkKC-Q1Xe,4,4,6,2,skip
@]KbI]>3@^`:rKWk\cX+rwMpXUPT@Yt2('SlIy,HQn$W[qyJ)-gWC-J-jk4(gVYEwh^%OF>\wkKC-Q1Xe,6,7,9,2,skip
@]KbI]>3@^`:rKWk\cX+rwMpXUPT@Yt2('SlIy,HQn$W[qyJ)-gWC-J-jk4(gVYEwh^%OF>\wkKC-Q1Xe,7,9,11,2,skip
"@^\&#UmJ4h}B7D=(<a,9G*7]d AW<,Z{<LlYD[","aKWHP3"")zrOz@^.Ggy>%vYSz%La\""],eEng@2""StJ;",4,4,6,2,skip
"@^\&#UmJ4h}B7D=(<a,9G*7]d AW<,Z{<LlYD[","aKWHP3"")zrOz@^.Ggy>%vYSz%La\""],eEng@2""StJ;",5,6,8,2,skip
@aS]*3U|sX_t?sg.Y-S7tGwr8`+_7^]JF~>XP4,h?!HrGcLo?t4:$8O9|B29b$^!Iy}x*MkNuxi8!k3^?,1,1,6,5,skip
@qc`+-jaRj{Hz\oZ?l4*p^~2!}1T:rPa18sTO^,Mkj_*c@J:yohoPOT(8`U#?cG{XIHhfpeqb79KLyzh5,1,1,3,2,skip
@rAdT<j?<p%bx$cHG;:e#BYFS[q w?Xg<{(W>.,5nLEFrNvHx`|lh0/e|+w6\Qr1vxRc{iBG&D<f-tyRL,3,3,5,2,skip
"@yx+SyogA! HJ6""H{EC_eK1~5*8!u;+Vu30ntL","\6^foYuyGl*7+'2)oLBEbA""13>>k72KN!&n[*hf?J[",2,2,4,2,skip
A+%)'_[K]6d'6CaIZhvGiLeQsR.<7a_g%3##D+,]y#k>#eLVP_?#!Djai!$apmv]JRe0dxnDlv5./V>j!,4,4,6,2,skip
A+%)'_[K]6d'6CaIZhvGiLeQsR.<7a_g%3##D+,]y#k>#eLVP_?#!Djai!$apmv]JRe0dxnDlv5./V>j!,6,7,5,-2,reset
A+%)'_[K]6d'6CaIZhvGiLeQsR.<7a_g%3##D+,]y#k>#eLVP_?#!Djai!$apmv]JRe0dxnDlv5./V>j!,7,5,8,3,skip
"A,L(PZ';S;>b9hes|c2rLd|)0be~`(3~]qR.l?",.<pP[.:IJ*TLH5vcwhN<(.A06I*^_yDfD4AH|}m tq,3,4,6,2,skip
"A,L(PZ';S;>b9hes|c2rLd|)0be~`(3~]qR.l?",.<pP[.:IJ*TLH5vcwhN<(.A06I*^_yDfD4AH|}m tq,6,8,10,2,skip
"A,L(PZ';S;>b9hes|c2rLd|)0be~`(3~]qR.l?",.<pP[.:IJ*TLH5vcwhN<(.A06I*^_yDfD4AH|}m tq,7,10,12,2,skip
"A.""%c)X=D/hQ<`x;q?MB=|r{jXK'C>.7{DORAK",FUz4Rp4zs>v@=tR/16P~nmKPUd0Zrd{bWp.Pbr1[y8,1,1,3,2,skip
A.IM~'%K&D-T/IEgO'o6wF{b^W@>[c7W$#*<x^,6J[:yWiN*&uyo}#:W%iWfL+Og'hpD<p-R*ZfdxOtIk,8,8,10,2,skip
"A6ec_*k.JvUJ&b[]=0`HYG5h-RWi_Qln,BD8U)","2=ZePj6?9V""*}:4xDh*)V;0ycS-xjGpt7}(aiBxb9;",2,2,10,8,skip
"A<,4_V!`*X4G$/q)O[M'Ux O}>Chl[mUHmQ,c^","{8MiP,yp}iDvvC%>]p(=t-(PHU_ 8ji~]R|AW>*:De",3,3,5,2,skip
A=X+4D5Co%^fIVqgN'dn.!e`g|R)DqP;L-&! G,l'sMQ*cjKtO\c_q{omdM245%=L;^Nl3RqmMm1TVl&T,2,2,4,2,skip
A@}d5i9xMw@$h\Rk2{(<MK DfLl:XwV)DteN`M,"5]:Os<oj""+&O$U^@V""^}5VJYZfk?mBMq.n3hdz#Ok]",5,6,8,2,skip
"AC2RxPqCU]DF}JXKW/~eH ,h@LgT.G)$2`^m?G",")[D,yE-+H=p8y-QD^stGulh1C*`-afr=7(ta9in!JK",2,2,4,2,skip
"AE'Q4jM5zJQ21wv|CK""^*w,S(DQ>m9s[k!^{Ol","Qf~Vi/Kp0K/hj`QMgLB9WHWrhj:?RZ#,/SJ/KmyCkY",2,2,4,2,skip
"AGd`=YO`>:]O5-CNz*7%&[@*""6~OcZf02Xi?se","<4OH3@}t2}kM`}I)w8DVb2md""M>3ak%&9mg[*F{9R&",6,6,8,2,skip
AR'4D7N/I1QAn_iH$US+l>`!(l;=NL?6) y\hf,"fSuy`&T7hJi9d}?,\DsM::ot-Id$O_(0_[7EE4}rJ_",1,2,4,2,skip
AY^Xbp0c>|$tE_[;x|vDgFN3;U'M5%I]~Cl`(I,"`><""0G?8XLzulq:dA1h [%8k?_qqj'L$V6kCWKe,LS",1,2,1,-1,reset
Ad nbews(u`:'KXZYI;cNs_XJh{64+2{KJ\i*Y,".?mZ,7.q<l7'Y,)f]p3O4N=>.<KtmXE*lIFD>Jp$hg",2,2,4,2,skip
Aey'0EU~WH+i?9q[qhYG1!]MFa9Kz bg3-vd!f,lT8)B2FUpj%ZIyB?\3Dy\6=NBRI80[_Wbh#Pq+:HU6,2,2,4,2,skip
"AfxP-Yo]QDo3?rl%)Vkub oA',s\f h]bjU|mA",3tBz$j3}!H?-u<vYt)Nl)/<%|YLJJMhFIesC;wf=*J,1,1,4,3,skip
"AnXZ0vrm>qzC!UU$,sT&R ;%8y2u57<jF@?W.y","r 4I,YC.=OqOr>5q$3ztN;_vwtj-4c>Nc`AkS_.2+8",2,2,4,2,skip
"B""KpM{q.E.kIpD=6rQ\HCTQ""P99;3zDqsKYK8B",{=jM`)2\}z$-cS@2;A.&?'jy^|ZW9o-sSv+S;@e>aa,4,2,4,2,skip
"B-H]3Q|*zc8W=7;ksh$/!-I|ks5[|""g7s+(H*>",#4=s@6e;PnGwTVX&Qwvn6^W>wxpL+*7`DSDPET&&g8,4,9,13,4,skip
"B?AMLosi""Z]Jxyp$j$w@^}y.^PwO  r>F""-!Q&","jdwFw{vaBH2TDV]~#^uXCpXl-erS`Z7~DD(s$C\,oD",2,3,7,4,skip
BNE\An4x\]4<Xmt#apIY)kK;Q?\*c[YIpWuFh6,"]Fo% ]Lx/NtGOH *u;S't*#S""0%AI[5Uxg&!; 1zG}",3,3,5,2,skip
BNE\An4x\]4<Xmt#apIY)kK;Q?\*c[YIpWuFh6,"]Fo% ]Lx/NtGOH *u;S't*#S""0%AI[5Uxg&!; 1zG}",8,7,6,-1,reset
BNE\An4x\]4<Xmt#apIY)kK;Q?\*c[YIpWuFh6,"]Fo% ]Lx/NtGOH *u;S't*#S""0%AI[5Uxg&!; 1zG}",9,6,5,-1,reset
BNE\An4x\]4<Xmt#apIY)kK;Q?\*c[YIpWuFh6,"]Fo% ]Lx/NtGOH *u;S't*#S""0%AI[5Uxg&!; 1zG}",10,5,4,-1,reset
BS^NbvefHVZ#/4R.0\UG_uf\<}5B7Tz7;rc`N*,c]BE4kvX-&'MBJP?+8aqIVVw'YjKV<m?Ki?DB3@1aU,5,5,9,4,skip
BV$ruNqe?y1*Hj]~I<z:wUBf07P2b*Z;*vc6hK,"rWCz.xSW0)y""Q}\rx9ySqiDSh~8M&)\IM.~N{W:Y;E",2,2,4,2,skip
"Byl\)VbxjeO/VHZ9,Nx2doW}IV`J;@U@Y[=.^I",B>#x1c'3ylrTM8h:N1_P_@\E0EL#vAa`^fVS+ezyKw,1,2,4,2,skip
C '&pMYa%7HdS;5}&5!`ccG4|%nGkz}vo!4[y[,"xp8] $X_""u6X$Q&]sk""eF_S^Q=<CEzDMTugSC/c&2:",5,5,7,2,skip
C2!G81cl#ef2z<tNN13+?'tPFL4M^/UNV82P_},?j\&/H7cUTH~0P{3q<GO=tL]K?0J04=5|V[?%Uok*@,1,1,3,2,skip
C4$/@2Q`t|7]nfE6~#^ .LX8Gnd(RB`'Kt8ze@,"IM6p]>QuUX:*47q,nkTnAx\ U)4J4yju=cS--U+p}l",3,4,6,2,skip
C8ER[4O%vkWS~.0>rDd3W1tl2+r<ckrwzpyI;L,"8OdnE~R&YY)IxxgP.J;)V2Fk9(gF-,f{}0L;h|tflZ",3,3,5,2,skip
"CC r4>oD>;""|6H""ip`Uga)rk5b&~0/'tmKbW[]","2Ca{Q""Is*#IAlGR<*KRTViz:so[Pv`NuW@=6|hhYP2",1,1,3,2,skip
"CC r4>oD>;""|6H""ip`Uga)rk5b&~0/'tmKbW[]","2Ca{Q""Is*#IAlGR<*KRTViz:so[Pv`NuW@=6|hhYP2",2,3,2,-1,reset
"CR;""Lk|xc<NWU>nD8qB9\(#EQ.>oXN{KOs`sg|",n-[Cmp1CFgY(hGW;et>(X6Q5XSf^)pfkp|jF+&5pF4,1,2,1,-1,reset
CV-BVLQ9j#.~f9Zu)_WGovQ&rI1dR+YF`~Rt5A,"{EtKGb.A??ePFbKsRNDM!C2u<5@@2,r,j(t3Dp;~00",13,11,14,3,skip
CZ0lGuvVX?:MwUNzg`D3R[&+T^d)RvyI9^N<8I,"Hf.3}>;9\s=S<O@BhZ9t\[:UWEI&'t_z~,&GEEB|54",3,5,10,5,skip
"CdCIhX8Ht""&uk#Iezqewg@Pic1KE2oSt(x<nR4","hQXrBpo\vxm ""_wqjR Z~B+TNRF-%$Akua@v]eg2Z""",2,2,4,2,skip
Cvt}v7eHD>39`E?%XPRn}t8xC@)8D2hEs>xEiJ,443OttN:_+wQ9e%x}t5JM5%g\3yQwVo *sPvqqWGQ1,2,3,5,2,skip
D))7]7lT3JJIm w!7Rn$%'Ff@2ab/%ZtP+=_0I,)cckLE~a~~&JrJI/>OA3o)tr;kepUH~[u+vw4tHMVZ,3,3,5,2,skip
"D,Y8w,XS*7l8Ve0)b{BgzWJan>0l,o`l`#0AtQ","Y?~uH3fXLz&- C$/N&""MlwZ6MkDSF)mW$^.[o3[H4B",3,3,5,2,skip
"D2vzd.5w(Vqj+qarmex74o#z/Y&%xzUcv,9r3R",")mqX~9:t$Awgw^S!D8l+0w NVK9g&b+hp]]J?T=;],",3,16,19,3,skip
DQ>8Me8(;h.>ALC6)Nhex>Ge>Z$E'b{g^[M/`l,",KhP~D:n-Z5Q.J\L{f<7<Fz2u$H%3GEWY""s3=H*$n$",3,3,7,4,skip
"DRrE>t0)Ds(ycF^}{P""TY,c$T {ar_ZKvh<F-d","Yp/C8R?j>uBuq+u]5yS)Z{w:&w*?q%qR>s<;,Rl""2z",2,2,4,2,skip
DXq_!dZ\JkpX0|5^q\cO!x 2XXBXTNnqGFJJ=t,"!ntTY4;j^j<Hz>6A2Fxj2KZv+8/a""9?\-Q}NWpYc04",3,3,5,2,skip
DXq_!dZ\JkpX0|5^q\cO!x 2XXBXTNnqGFJJ=t,"!ntTY4;j^j<Hz>6A2Fxj2KZv+8/a""9?\-Q}NWpYc04",4,5,4,-1,reset
DXq_!dZ\JkpX0|5^q\cO!x 2XXBXTNnqGFJJ=t,"!ntTY4;j^j<Hz>6A2Fxj2KZv+8/a""9?\-Q}NWpYc04",5,4,6,2,skip
"Dd}E9;|'*8M""g-rN7 V<EU6?4G,Trhy+p0{L(`",",}SD)P.6qAq?Jvmj@lk>CuwXQ?,L9V,ql#'V&& xN*",1,2,1,-1,reset
"Df(3SlI;U/H(.d*0-6DvB""bCqr7MC),km:(|uj",sAmuZO=+Wxi7v*HYMf=6X27kE[1!O>H#fP.Jr' ~3[,1,1,3,2,skip
"Df(\~]=v($Ra=K~riuTw|l]a[hOk,B;Ile37L+",kH!4(gxGCbGhfe[T=#vH1OLnmL-}l[k-*i_KxqpnPM,3,3,5,2,skip
E-7Sg)4;1-qNO71IP[yy$(}L#Ti^{>!s6C[6Y3,"P#IByubmlJkH\1@ 1,a)+.cSUU,Kfo`O347! )-[.-",2,3,8,5,skip
"E:XVI?liMvohn""s9j]^%FW^9{xs{masJm/qSF^",E>(|V6GfS7*I(B*TM`I_.Slxy$qWE1 P;-O8h]?7]b,2,15,17,2,skip
"EVU\Yj=BMk_/->\&XhAZ.`cpsBsc-X2,gA)1r3"," }=5fF|TNw1=-G[wZJ{#L~eq_}bV_5hYjNs,4l=/3b",3,2,4,2,skip
Ebn=XeVM#gRxCZ&7J5}$0tn8F(:iUT|[f~Y+_p,_G%WYD=HPAZ:>@Ln;{M5@ c pyRC7oCpVy#wyTpF/h,5,4,6,2,skip
Ebn=XeVM#gRxCZ&7J5}$0tn8F(:iUT|[f~Y+_p,_G%WYD=HPAZ:>@Ln;{M5@ c pyRC7oCpVy#wyTpF/h,6,6,8,2,skip
Ebn=XeVM#gRxCZ&7J5}$0tn8F(:iUT|[f~Y+_p,_G%WYD=HPAZ:>@Ln;{M5@ c pyRC7oCpVy#wyTpF/h,8,9,11,2,skip
"Ekn,wJvas,XV`Fadj}[OL`~Rv*Sv[:}%>G+&:H",/511NXsiUWm@v#<hIZ^<\0|p|}!E]anu2r#hHi>xNR,2,2,4,2,skip
"El""jF 1~b0B&d`oc)Ax-OA*[?]9:E^xG,@ #_9","7rmu~Wyjw0A;X4!i+#zFz1=/""7X's6JTYVM;tIc?SQ",9,9,11,2,skip
Ez{zpnj %/O0p4Tur(!Rc?R4jh2F<}Lz`}bR>`, l0{_|U5G/3sIPrc90GKzdDYlPV7WTcfI.-zA>'A3},1,2,4,2,skip
Ez{zpnj %/O0p4Tur(!Rc?R4jh2F<}Lz`}bR>`, l0{_|U5G/3sIPrc90GKzdDYlPV7WTcfI.-zA>'A3},2,4,3,-1,reset
E{X`(|8[rXY@}.*mA#*|)}<TpNVJrZ%<3[0SI(,wNK`T~shspbqN3KI$/a$gj<^#AM#h(yI>C4EU>/0O!,29,31,34,3,skip
E{X`(|8[rXY@}.*mA#*|)}<TpNVJrZ%<3[0SI(,wNK`T~shspbqN3KI$/a$gj<^#AM#h(yI>C4EU>/0O!,31,35,37,2,skip
E{X`(|8[rXY@}.*mA#*|)}<TpNVJrZ%<3[0SI(,wNK`T~shspbqN3KI$/a$gj<^#AM#h(yI>C4EU>/0O!,33,38,41,3,skip
E~x\J{<*>A}PQ_EW?Gvk(>3TKspB/m+j_K5g3^,Ah~@:EldxNyS(@ZH*Nvjb>Sw{TXp#O7eE0NI^=JsaV,2,2,4,2,skip
"F!fHFemwUn<`Tw/oivPDx6y%TN;N,#]*A>32HX",!r$rfV*u}/3Lwn+{vuHAHjTre9fG*ex>Cs8Ug`E}p|,2,2,4,2,skip
"F(&mKxpXq_X#2h|e`<c?$L[NDU,R""|K1Tg""8rK",ZaCRPTn+CB_G@2H#% -Sp'J:]3!`)'Th?ia'4x[w3T,2,2,4,2,skip
"F6(\4W%uC$-M~*biv%7X@mqJ6J(CPE9J-K(Yy,",m)\TyzXsf%;1;:;Z9+%ebv?a*9gKhJ4GPh8.?fxD/{,1,2,4,2,skip
"F9838B(.eGQCkE~vGt:<t$%2}m1i8bo""_ZHKe|","br){Z6MT4jr|HUPN9!;@b)H>I,L>pEp#^.t?2M_4q\",1,2,4,2,skip
"F9838B(.eGQCkE~vGt:<t$%2}m1i8bo""_ZHKe|","br){Z6MT4jr|HUPN9!;@b)H>I,L>pEp#^.t?2M_4q\",2,4,6,2,skip
F9?oD.?h7&])!_CQ)\fU.!;m^[D:BQ13a-UQJ[,"($^?-0(>,>k)*01=jv)N2#& }B^]NEgjIJ"";ucRFnj",3,3,5,2,skip
FG~?+p*Dn2kgzNRq/FBT!%i_]o;57(<ol-|K&.,TkKKLU ]ZvIPJt~>S0aYAfw$_z*EJN -JlegU9fG|E,11,11,13,2,skip
"FHQ/\^i4)+/8mr* >4 M,XlOX1xR1)a^b1\$U%","gIHM3D5j"":svjif*X6hdO|z""z#5%eC;v9vuV!G""""md",2,2,4,2,skip
"FHQ/\^i4)+/8mr* >4 M,XlOX1xR1)a^b1\$U%","gIHM3D5j"":svjif*X6hdO|z""z#5%eC;v9vuV!G""""md",4,5,7,2,skip
"FHQ/\^i4)+/8mr* >4 M,XlOX1xR1)a^b1\$U%","gIHM3D5j"":svjif*X6hdO|z""z#5%eC;v9vuV!G""""md",5,7,9,2,skip
"FOg[5TP[UI>+d^rQ':k M[Y""-2ZyU*8%P%d1sv",k\$y?u.|JkutfQs:?$IX/D%z?[3iXX$/f:M{3n6q^U,2,2,4,2,skip
"FVd3pX[D/G+6Q6 62qd*iQZi,6;yO{WYEjJX+'",Gd%#.-;M4TaxHXyI)>]_MdmH+06<]/~#`OLm2.3l= ,3,3,8,5,skip
"FVd3pX[D/G+6Q6 62qd*iQZi,6;yO{WYEjJX+'","Pq""|:vhNs8'WB  \%?mT 0G6iq]r:M m""Jt0f'ddfj",3,3,6,3,skip
"FjqoBADxd_i0G-m%zC810[djf:C+UQK]}:""X:;",o^d*hV6\E[&LOvnyj-nQHq3OSt;!)WodLrPr-P%-A',3,3,5,2,skip
"F{p-Y)I>u~^H!1Ku,@pD\D/5)n{y]#>JdtqUr0",I\4N_0-~0%\iQmPK]cK-.vINlyTpFx0vw \G<AhHq7,2,2,4,2,skip
"G,hZ|dz[/86#1ZDZ{Q@Zl$^y[}%kL^H(Mw<}{U","-T7n?T$/gtwv""L.[g7'`*]r_.rd_~Iul#MBIF_s~ST",4,4,6,2,skip
"G1ln.Rwk= /uAcv{=:.L_57G.Nd_Z,hfoxo30f","<gS~FswDv""t?0*'~{*LU<b0Ca8g8geiLOT!5+ZC[Vn",2,2,4,2,skip
"G1ln.Rwk= /uAcv{=:.L_57G.Nd_Z,hfoxo30f","<gS~FswDv""t?0*'~{*LU<b0Ca8g8geiLOT!5+ZC[Vn",3,4,6,2,skip
"G1ln.Rwk= /uAcv{=:.L_57G.Nd_Z,hfoxo30f","<gS~FswDv""t?0*'~{*LU<b0Ca8g8geiLOT!5+ZC[Vn",6,8,10,2,skip
"G4BO@?\R^>O2+q5xkHd=aH&[cjuc_AK6P:D""$O","p2Dq8ya{.n1wHMHW$E>t:c5iyneZ,!.ck{_t55(t%N",2,2,4,2,skip
"G4{B6`}vXMlv07d""'SC>mqoN2; R}]'#%noclA","z^Kn|RE}9sx$B:J4ZV$8 (R(7""V{<MGfA,o!RoND'5",5,4,6,2,skip
"G9t:""uaVA!HEDTf)rN@u3`S|;|^dJ1@mY$<w>O",o{^w~vj*Vl]CLiO-!BWAK G]s<[lZ`)p`])!L50BBb,1,2,4,2,skip
GP=|0x+wU;K:78}=7PWL=5Jen/Js[}Ka#eu+z],"Q,8yyIUo}D^|j`,@(iufhc6?X;gvoTI\t5Qk]}~pHD",1,1,3,2,skip
"GV:8nJuw(K\Zh;k|s2?JQ""Jm_Oq(3TTHy@.[1<","$(ZB1,yuAA; NFau'>t&(#u;/+N=fjN,4gT=8A_VU!",2,2,7,5,skip
GlQ&5`t~)-)We;O^hgkp.K;[x5btXo2=f/N;v|,I`KG981S0:tWLG>pf`d#`Leb`>j(CrYW5/6qcq-9`4,2,8,11,3,skip
"Gs2Py8j-(B\K4gB=g?a?:8DTxR(e1O#Lus,!ah",OtT`zEGbozm$e1RV/p%uk.>~l'sdBC<sG2DIA)*jBu,1,1,3,2,skip
"Gs2Py8j-(B\K4gB=g?a?:8DTxR(e1O#Lus,!ah",OtT`zEGbozm$e1RV/p%uk.>~l'sdBC<sG2DIA)*jBu,2,3,2,-1,reset
"H-uoj-IyP`K6rvz^b6Oa?G}~7Mc,H{:1@qwEh>","n)e=tVkdD2X,_@y vMS)0#((N;0\h!jonl&L3]hPD,",2,2,4,2,skip
H14}]VG%)WB3J?[mhEaooS4{tLUnL)cX:$hd]>,"o|XAbl6QHMTqB0D(_]9H!}p4.=pw1>@(cT1Z^,h1/*",5,5,7,2,skip
"H8w/[""XV)P  p8/[T~~lbDL&%y7Orum.)[T//M","DtImQ[MMCrGFM0qq\X3h.@jicwXab*A7W~<?9{q)t""",2,2,4,2,skip
"H8w/[""XV)P  p8/[T~~lbDL&%y7Orum.)[T//M","DtImQ[MMCrGFM0qq\X3h.@jicwXab*A7W~<?9{q)t""",3,4,6,2,skip
HXcy>/T F:p]Nei<JC6z8Pip|&Ot+(;OV=s8dm,"/OY~6m9m)V9k1%+j<UT,O3Jk!G;Q05/;V0C=<Vl2qj",3,3,5,2,skip
"HY`9K%iz'MA=a3;T68Pg ""VzYis;h9 >mJ6A/""",jh.iL:*O_ta@keU{k73PN6![|}*m+g;@aB#4L>V-(a,1,5,7,2,skip
H^ah.Ya+K_8}(IHi#-Z+x|WQS^u=#}#w/pC)sY,R_J_M?n \O>ieZ|QB=ZF1-l'9Z ee|3B5L/Qm)?FN$,2,2,5,3,skip
"Hd9lCKrTa4:}YsQ,0j6,YCmrQ4=?tYdvZ3!n(T",XLu08-/bGX_[S;}f?ZHEts=QT-pYhR-Jw1f|jfm:4S,9,5,7,2,skip
Hn1w8>c**!Oc[QS!Oc@~c ^&[vE6-%D#A/!ijj,X6sGS:Yj/_A5u6K.myabU9ctWc'!!@aN[&U<*|LUlQ,4,4,6,2,skip
I$H3-]aXD j}qRn+bSvrAg4&( Ob=Z(49lS/%j,!zh([q\OZ5zB_R*!ST!0)_Bzm>WC?J@*GN'Q9k2]zU,3,3,5,2,skip
I(*hP{*CeXb6fp<K~<~qDZ7NT9zwL2T#Lh[|-Z,"!.xtU?ap5AWK4_i_/x?C""}]/sKj<upEP{CO.v5*]&R",2,21,20,-1,reset
I(*hP{*CeXb6fp<K~<~qDZ7NT9zwL2T#Lh[|-Z,"!.xtU?ap5AWK4_i_/x?C""}]/sKj<upEP{CO.v5*]&R",7,24,20,-4,reset
I(*hP{*CeXb6fp<K~<~qDZ7NT9zwL2T#Lh[|-Z,"!.xtU?ap5AWK4_i_/x?C""}]/sKj<upEP{CO.v5*]&R",15,25,21,-4,reset
I(*hP{*CeXb6fp<K~<~qDZ7NT9zwL2T#Lh[|-Z,"!.xtU?ap5AWK4_i_/x?C""}]/sKj<upEP{CO.v5*]&R",28,29,14,-15,reset
I(*hP{*CeXb6fp<K~<~qDZ7NT9zwL2T#Lh[|-Z,"!.xtU?ap5AWK4_i_/x?C""}]/sKj<upEP{CO.v5*]&R",34,18,15,-3,reset
I(*hP{*CeXb6fp<K~<~qDZ7NT9zwL2T#Lh[|-Z,"!.xtU?ap5AWK4_i_/x?C""}]/sKj<upEP{CO.v5*]&R",37,17,15,-2,reset
I(*hP{*CeXb6fp<K~<~qDZ7NT9zwL2T#Lh[|-Z,"!.xtU?ap5AWK4_i_/x?C""}]/sKj<upEP{CO.v5*]&R",49,24,23,-1,reset
I(*hP{*CeXb6fp<K~<~qDZ7NT9zwL2T#Lh[|-Z,"!.xtU?ap5AWK4_i_/x?C""}]/sKj<upEP{CO.v5*]&R",51,24,23,-1,reset
I(*hP{*CeXb6fp<K~<~qDZ7NT9zwL2T#Lh[|-Z,"!.xtU?ap5AWK4_i_/x?C""}]/sKj<upEP{CO.v5*]&R",57,27,23,-4,reset
I(*hP{*CeXb6fp<K~<~qDZ7NT9zwL2T#Lh[|-Z,"!.xtU?ap5AWK4_i_/x?C""}]/sKj<upEP{CO.v5*]&R",59,24,23,-1,reset
I(*hP{*CeXb6fp<K~<~qDZ7NT9zwL2T#Lh[|-Z,"!.xtU?ap5AWK4_i_/x?C""}]/sKj<upEP{CO.v5*]&R",64,26,25,-1,reset
I(*hP{*CeXb6fp<K~<~qDZ7NT9zwL2T#Lh[|-Z,"!.xtU?ap5AWK4_i_/x?C""}]/sKj<upEP{CO.v5*]&R",67,26,13,-13,reset
I(*hP{*CeXb6fp<K~<~qDZ7NT9zwL2T#Lh[|-Z,"!.xtU?ap5AWK4_i_/x?C""}]/sKj<upEP{CO.v5*]&R",116,61,58,-3,reset
"I6@Iv},%6b\:$4jj1Z_PkoG5Tj&nr}wg]Vs""H""",y}\m:<f(!V*PHSM_0ID~'h-;h{h>lR*P1J.ZP2i=j$,4,4,6,2,skip
IB7%Xnc\nj~.f9/@GoQW9\ #AN|nmkw_]mX\(m,"fk-i~sER)Xk,1o(mo%S$9$JTP?9(\HIxRFjI,Mn0x+",2,2,4,2,skip
IB7%Xnc\nj~.f9/@GoQW9\ #AN|nmkw_]mX\(m,"fk-i~sER)Xk,1o(mo%S$9$JTP?9(\HIxRFjI,Mn0x+",3,4,6,2,skip
"IOf7pdM;4OP}V2ISCk5SD(}wVZSO<:Pi&:~}""n",")Ed{~)-~>673~9""w/Ya/guH{\q<d`3mp]qU~HZ/pe4",1,2,4,2,skip
Ile.gU(H/#X8}?-Pm1+=\}GkA.qm)LZ:tc<2XB,"QH[`naeHbw:()L5O*|Q""`Vxn+&[6V)3e?6[C5cOXF@",3,3,5,2,skip
Ile.gU(H/#X8}?-Pm1+=\}GkA.qm)LZ:tc<2XB,"QH[`naeHbw:()L5O*|Q""`Vxn+&[6V)3e?6[C5cOXF@",4,5,7,2,skip
"Iscq77+i{8>RANg]5Xrs!,v`YEpDyI[n_qr17a","ilxAd!^px*HWN?x""[utC='SUtX%mrh!}""K56nrm9j;",2,2,4,2,skip
"IsiFT9kdAE""OwTr92^9mNzWUia??jJ#c+>v<0i","%+aQX,aX/S(0""iRom}cDjqE6>l[f+;jk]Ronm=""WN.",3,2,5,3,skip
"It,pfx}I5(.$9\n4Ytnri%Of+Z-Da^8U>81NOk",77Rr9HxJ\OO1$C9w96Vce:)>N6k1yi0=Wu_?kRs+1M,2,5,7,2,skip
"It,pfx}I5(.$9\n4Ytnri%Of+Z-Da^8U>81NOk",77Rr9HxJ\OO1$C9w96Vce:)>N6k1yi0=Wu_?kRs+1M,3,7,6,-1,reset
I|?Sq56)HWG?sk;+a{fwm&EB/2vZ2C_5}n= &i,"Qa>cGIZ-%""Ke?.=| rC$-DkKOnBz4dKtR|oT5sJ!Tt",7,7,13,6,skip
J!Vt5gQnU}x%raZ0>g~KaJ`jE-mcjTNWtvQ7td,"wk~u]#a|<:XjkHd+f v1""6jyLv}?op_&F=Uqzp)gGO",1,2,4,2,skip
"J"" $f7r99i<u$R1! MEK_^pZrD]}M[d^!db[w\",G$})Q+K>M}+S#j!maFN%K77t&J~9DEw1vv3l=@7|N&,2,2,4,2,skip
"J"" $f7r99i<u$R1! MEK_^pZrD]}M[d^!db[w\",G$})Q+K>M}+S#j!maFN%K77t&J~9DEw1vv3l=@7|N&,5,6,9,3,skip
"J"")-vp]Qze?/L8bgcFc:5#LJaYl}<08UB*jR}t","CfU|Z\vlO_?_]{T""f!*h$W~3QryJ_|sZ3P@dd7eR1E",1,1,3,2,skip
"J"")-vp]Qze?/L8bgcFc:5#LJaYl}<08UB*jR}t","CfU|Z\vlO_?_]{T""f!*h$W~3QryJ_|sZ3P@dd7eR1E",2,3,5,2,skip
"J""S'FWY7~uFx MR:/+k=mhwLCw *cVFpG_V\:T","}>h#%8[&^[f^#jT!GNNn`xb7lLW#]m+t,TS4d{ !WB",2,2,4,2,skip
"J$*aqi^@/:""+i?Wj2M)@o0qg?yzfR\dY,,iZD$","686o""Y>yU2i=2p""r>Ecwe)EkbsjT]d'hVu`Wx6cLM2",1,2,4,2,skip
J&*]G=OPo'O3nrA(.JW48I`VBP%P$Q1xq]OXpq,"I<4#7pN)$pt1Q/Ac[7%l=$e~RhVR""~n UV'RF+o))r",2,2,4,2,skip
"J-i=?D|{n~""0onfL{+8$]5:R0\%VXPsX) XlG(","|""#L'('i:PP#V!R]uYx:o05Ovti/<s#75=j|l{b}{.",28,27,29,2,skip
"J-i=?D|{n~""0onfL{+8$]5:R0\%VXPsX) XlG(","|""#L'('i:PP#V!R]uYx:o05Ovti/<s#75=j|l{b}{.",36,32,35,3,skip
"J-i=?D|{n~""0onfL{+8$]5:R0\%VXPsX) XlG(","|""#L'('i:PP#V!R]uYx:o05Ovti/<s#75=j|l{b}{.",38,35,37,2,skip
"J.AWNXwSL[na`_BBZTEI Y<KH-=j2k2:7O,gU4","aFI$kWmpX~Bbp.P4L/xtbbE*""0sy!6 @*nTc)O6tCj",1,1,5,4,skip
J7pXhI<D2(f|;llsF5jU:$*)<7CtYlDb3U@!bS,&Km|8UXK|j^e5_c]?7q{%FI3Ub)]'9utxt-jJR%=dC,2,2,4,2,skip
J<>o^|/wJ;L'TU]E<%zl'RT014Rwq2bi6jHx=2,"\nAz+q`a4EHE;DB< ?t=0%DTZSy:""Cp}f""g|oX<(;D",5,5,7,2,skip
"J]bqO,(^T?`nU$*gAK^:NM&gBO[))d|-UuiA$r","*|9K2N>a,mMX<^/Hkfgk4qQL>'p D$6NG@<]EI+{~y",9,9,12,3,skip
Jg>7J: &RS+i?7ZHB2@Rn^_bD?RRm=>3_4nv+R,"I<a/|vcG,KNn|QS'<|<VnF9)unsy$ts4-iOD13~&I5",2,2,4,2,skip
Jg>7J: &RS+i?7ZHB2@Rn^_bD?RRm=>3_4nv+R,"I<a/|vcG,KNn|QS'<|<VnF9)unsy$ts4-iOD13~&I5",3,4,6,2,skip
Jg>7J: &RS+i?7ZHB2@Rn^_bD?RRm=>3_4nv+R,"I<a/|vcG,KNn|QS'<|<VnF9)unsy$ts4-iOD13~&I5",6,7,9,2,skip
JkYa_w\o^p8C>~;u2X(+(xBycMk8gBH<22U7]b,2s/y)Evxn'*x}];2BubkQFU(+6FB0df`z|Eb0M#2& ,11,10,12,2,skip
JqPay-PV/\#ucw:/u*mL;q=e*DG2R%j4VLCS@~,{O7{3bLi-c 2^6]uO;bf`e2St|R\OFv;w|Uqj?XPUd,1,2,1,-1,reset
JqPay-PV/\#ucw:/u*mL;q=e*DG2R%j4VLCS@~,{O7{3bLi-c 2^6]uO;bf`e2St|R\OFv;w|Uqj?XPUd,2,1,3,2,skip
JrWYo8@/^ru(6po~:X&PJzJ50a^d}5`<R9-^HL,*arIv5X=0I[JRuE8YU1@i4X#d<%'\M'fP}L'tqw{)!,2,2,4,2,skip
Jr_M/?|$K=Vz5RDyACmP)4ie'fr %_hHsY$aiY,"X;q$g""qkaU1D<N%oT<fwIydz{1;H^L^AS""q(&2M#Jd",5,5,7,2,skip
"Jx:^I^e?a.!Ux</!b[6kDf2jfw@n=Aqhq'=),?","+ID*N5AY16h]^*z$8'QZ|Z{B.bo""7[qD;@N|+`?8>/",2,2,4,2,skip
"K%tN[aj~3wS<NqutwonrE>1CQg'RS(z>`;L,wZ","6r{f*^7O|Z:,*rj/xq-jM++!O%+FMJ14T%^!IJz!  ",1,1,3,2,skip
"K%tN[aj~3wS<NqutwonrE>1CQg'RS(z>`;L,wZ","6r{f*^7O|Z:,*rj/xq-jM++!O%+FMJ14T%^!IJz!  ",2,3,2,-1,reset
"K%tN[aj~3wS<NqutwonrE>1CQg'RS(z>`;L,wZ","6r{f*^7O|Z:,*rj/xq-jM++!O%+FMJ14T%^!IJz!  ",3,2,4,2,skip
"K%tN[aj~3wS<NqutwonrE>1CQg'RS(z>`;L,wZ","RcY_xb&5]07!j\1:d,VTB!hp@Zy#pUfd%vFdJXb0(q",41,39,41,2,skip
"K%tN[aj~3wS<NqutwonrE>1CQg'RS(z>`;L,wZ","rlxJxChBp]1$U2^@uH^fTb89rx=_8YYI<e""Q@gFgkN",19,19,23,4,skip
"K1!7yM,u'ty2B$(GC]|mvAZvzqqu]p#;kp1iRf",6Ed?s&(yj^!!|@UaQ2LVWa).RgR$Qga'I9T&b0zGuN,2,2,4,2,skip
"K1t+i L(M*+SD-Bj>\,S-t@1|gnFii$RnETMW]","ZTJhmk!.&ABf{""Xe*Gk1}jh3oAFr4qtpma0EJ:0>VK",6,6,8,2,skip
K4aYA0L|>eOux5n.V8~AzVo)]MFH~;.WUw$uLR,R%c}HVm25?x3>:OAgun!8[Y_R$u3w=@C&m&|TqUiR~,6,6,9,3,skip
K9;rhTaGMo[h3Zj+Sv~5qQ3<iRaf47v!Y 9a(J,")P&|$e3)cC0@+L0&tSZ7s&c,ruX``uJyg+Bo\CH2@M",1,1,3,2,skip
"KI?OD}S""l6.4gb}8b""r?puhrxm,H%YSsnV""aLG","NAY'DHzb5$v^>d_<5Jh)GBh,rLhz<VN)Q`'(37:Deg",4,2,4,2,skip
"KI?OD}S""l6.4gb}8b""r?puhrxm,H%YSsnV""aLG","NAY'DHzb5$v^>d_<5Jh)GBh,rLhz<VN)Q`'(37:Deg",5,4,6,2,skip
"KSWdZ0:mJph(GF_f~qs.}G{fKUtnAT:,>NA}yd","eV_N rAe:}66K{9D;cJxcTX]BVE$r,LJxvNH?uw2 w",3,3,5,2,skip
"KX=:Vg,'+w$w4IwkQ{L2iA|SM;^6Pa$A:r^5pR","kbby'F,/c|$$>apr8piiIz!;T7s+vUV&YI>-@{F.`M",3,3,5,2,skip
"K\f@B""[+'U@N4& a!&`4(d}_\W\MB%pX0mViG.","85uUs2/duE)y8J`jRCz""n{]&eloK(+VjMa#:uhwi!p",3,3,5,2,skip
"K]EN,$G:e6PX5_[)En!TxVB`6|Sz 0i""i,x'3E","|SYQUK&zheAcm $RT?ZVS'L7\!YPd$j""lKZ]$`5=zK",3,3,19,16,skip
Ka*h#qI?B}c_By1F#*y<{A[Q)GDVO+ss<X)RWS,u\||\NIPB9}v3.Jj1/6RB\[iC<ja9s-if?`qZ[wT0:,7,7,10,3,skip
"Kex|U?=b+~f_Oxm4nFTrz8""V:92""HJcFC`&#4y","Vc,u^S%#BAP;(>8g>Z$v0>vw|4:)RRFVP0o<NN=X,X",2,3,5,2,skip
"Kex|U?=b+~f_Oxm4nFTrz8""V:92""HJcFC`&#4y","Vc,u^S%#BAP;(>8g>Z$v0>vw|4:)RRFVP0o<NN=X,X",3,5,7,2,skip
"KpO^MLjoVD""*EBb1,}Z mC~Ix'^Rk60w;8;oHk",$N7{'I.-h!.$Y8W^ICO3[G2N+\1'vf$(n]3tSN'~>8,1,1,4,3,skip
"KpO^MLjoVD""*EBb1,}Z mC~Ix'^Rk60w;8;oHk",$N7{'I.-h!.$Y8W^ICO3[G2N+\1'vf$(n]3tSN'~>8,3,5,7,2,skip
"Kz8N[4ovlKe7\Gav!!H/Ev>xF_s$""_YL(:}E9R","T_?OVu$r@m<R~l C41)pX4""rbU_:5dPm-RS|R O[4'",5,5,7,2,skip
L#y;RwLD]4UcQEJ-f%Ai91vF]=4#+J)qakcz7.,"z0S{d_swId;Zw!BvG_VmH6FtN\""F;dzlJ1]/t>7`3+",8,8,10,2,skip
L#y;RwLD]4UcQEJ-f%Ai91vF]=4#+J)qakcz7.,"z0S{d_swId;Zw!BvG_VmH6FtN\""F;dzlJ1]/t>7`3+",9,10,9,-1,reset
L#y;RwLD]4UcQEJ-f%Ai91vF]=4#+J)qakcz7.,"z0S{d_swId;Zw!BvG_VmH6FtN\""F;dzlJ1]/t>7`3+",10,9,11,2,skip
L0~i*N(\#mP!Q~17c=1Qngb|$z[Jki4U-(P8}1,"eGy+/{1}:LQ3""Ib-m5</zPXRd'T!.o9vSQ84ulta)]",2,4,6,2,skip
L0~i*N(\#mP!Q~17c=1Qngb|$z[Jki4U-(P8}1,"eGy+/{1}:LQ3""Ib-m5</zPXRd'T!.o9vSQ84ulta)]",3,6,11,5,skip
L0~i*N(\#mP!Q~17c=1Qngb|$z[Jki4U-(P8}1,"eGy+/{1}:LQ3""Ib-m5</zPXRd'T!.o9vSQ84ulta)]",4,11,13,2,skip
"L=ZG7K_\Gb$[ZIub uw[ut+ '_E83pH <V*,%;","Bb@8@r4EG`kSvRhca{*wHKZ+[ xc1XR#7ppAe,|g(w",1,1,3,2,skip
"LC7sHE'U>pVkAV9a8P,K@emJ.$P_iz6%4a4wL:","RyU)[[ m+HX!tJ'n9]`J)5i.c""cdeb{u$2M)QolV[(",6,6,9,3,skip
"LH})l;9\Lg;c@'Z9GOZU.[@Bx:ii8t""u>6,uf^","DbJ4EW:`r<nZdB4EX2sn`{[NalLLPAC7\2+U,aXpP\",10,9,11,2,skip
LKCi@DVoE:n6.1#e(qz>ydSJNr 2GWY:]FB4I1,",,.M$NPf@R77!Nh3p#[P&)&]NT(i!O|#J@I)cC(|a,",3,2,4,2,skip
LKCi@DVoE:n6.1#e(qz>ydSJNr 2GWY:]FB4I1,",,.M$NPf@R77!Nh3p#[P&)&]NT(i!O|#J@I)cC(|a,",5,5,7,2,skip
LM7;F2`'c1?`yLj[{ J1@7=e4I'v^Q~@Ib|O3E,"K/hMHU;SR_D $gyzKW)v{/{Z;hglZi1,s?Lu*x'ws\",6,6,10,4,skip
"LNK""r80csav=?kFIi&*Je}G7\]y@moG.(/\UO\",lbE*Z\da`$3XZKx(-99C>s>UG}5AM&s.QAU!~kA9m5,4,3,5,2,skip
LPp4|@^G1RWCFw'Izhfrn`TOTA9t ZdWWvGykM,"@sRYnplG{i_W`Hu^h,&=D{N|a/`ZHHx#C~DM^{0C`}",3,3,5,2,skip
LPp4|@^G1RWCFw'Izhfrn`TOTA9t ZdWWvGykM,"@sRYnplG{i_W`Hu^h,&=D{N|a/`ZHHx#C~DM^{0C`}",9,10,12,2,skip
LZ 8ifq+H+\2Jckx_-evcAn}.ol+eqwH;nV#41,"n-{<hGM 1S`P,906_,NG+T923&#uL2t/lpxJjxtMpv",1,1,8,7,skip
"Lc=^W(#iR=tf]Z5p)jy=^L""]F(|G%0#$(HTh=7","ev${0cz""9Vc\gr9(2%=O!z3iG7B|rkfMo6KGdzP[o&",3,3,5,2,skip
"Lc=^W(#iR=tf]Z5p)jy=^L""]F(|G%0#$(HTh=7","ev${0cz""9Vc\gr9(2%=O!z3iG7B|rkfMo6KGdzP[o&",6,7,9,2,skip
"Lc=^W(#iR=tf]Z5p)jy=^L""]F(|G%0#$(HTh=7","ev${0cz""9Vc\gr9(2%=O!z3iG7B|rkfMo6KGdzP[o&",13,15,17,2,skip
"Lc=^W(#iR=tf]Z5p)jy=^L""]F(|G%0#$(HTh=7","ev${0cz""9Vc\gr9(2%=O!z3iG7B|rkfMo6KGdzP[o&",14,17,20,3,skip
Lh0_F#BmCIK@d]ltwSn|a\s@1bl8sb}S</ioRt,;)8;4nM S'A`V$av&Xdv&4Gh_3{T(haD)%-BZz?`21,2,2,7,5,skip
LryjJ[0:q'_a>>MKgAaCwULA%!Wr?QLzx0\dRj," Ya4yJ#>K>\NOS""b]S8Pw=pe{+ydN!I<1}^ TwYFa\",2,2,4,2,skip
"Ly4i4q}Qt""<9vPilwU}@Jd=kojW(MU`}>E3/)Y",$KW/g3{p[NrQ=[bYTw*m`SQPgk-0XDx[\n87`KCS'6,1,2,1,-1,reset
"L|Pj~N~?!tATtQ5!Y|BJ#sR(iA'xV{Fvd-,T8]","ySaU+mb[N2(dF@:xCOFyz~,za@6>BHTN+mmH4OA@~k",1,1,13,12,skip
L~3_2%Phem~l7Ow}zNjt-_RR(/n?yKXdPhSD2I,"bT6jG-g5=kS""+p u%,9GliH~@zfL-)nP'k5x40KbdT",4,4,6,2,skip
"M!uJ!*ai?qL$(o*Pp-osafPwsGD,DT.5W""s])|","A""@0{}S@(IcX-sG?L|*Hs8EIv?I4O<ZE&dylSK7jGr",2,2,5,3,skip
"M*~3b2\_U%Mh5KVF)qN<Vr+$2,KA:qltsX'?3T","R~JH_w1sKK>WcAT;`%DElY{a(K<$Yx@9w'""FhR1.Hq",2,2,4,2,skip
"MK?,)[S3LUTr6l~aQH.Vh47IJx_V_- a[Bqg[1","DmKH+G<hvWb#*[7zPE$l$""zEI!n! o00M7q!yR8|',",8,8,10,2,skip
"MK?,)[S3LUTr6l~aQH.Vh47IJx_V_- a[Bqg[1","DmKH+G<hvWb#*[7zPE$l$""zEI!n! o00M7q!yR8|',",9,10,9,-1,reset
"MN0D{znfIGz5tu`7DMSZkuC.Zx,P'YJ<[|d#e`","0QfVn65BqM8U<rQy]VHc14w%D;U(7>&Xje\oZ.x""7v",4,4,7,3,skip
M[/3!P]bMBCn*rRo4g5Z6PJxG.'Rq;Bhxp[J(m,Feo#sC  MJ=aHT{Z|pZYw!p&6`i=yQCK4<f0'k~QB_,9,8,10,2,skip
M[/3!P]bMBCn*rRo4g5Z6PJxG.'Rq;Bhxp[J(m,Feo#sC  MJ=aHT{Z|pZYw!p&6`i=yQCK4<f0'k~QB_,10,10,9,-1,reset
MdC3R_)su3qRYD36bx)5(\CkW|{{Kd^7j^$~sS,)BFmIzS[Zm*1W2=S$PVw2d~}|3|.1#sU4(f2Xg>>ZQ,1,3,6,3,skip
MdC3R_)su3qRYD36bx)5(\CkW|{{Kd^7j^$~sS,)BFmIzS[Zm*1W2=S$PVw2d~}|3|.1#sU4(f2Xg>>ZQ,9,13,15,2,skip
MqP&v&n;/EZP=6NU#oJQDo6Q-7Jwl[abnh.&gW,>jxiFg%WX;{|Zvj0pa/r:!B&/DhI@O9Sr=$0D'dw^T,2,2,5,3,skip
My:;jw1#R80Imvp%([`#6v-&<wjhEy$P{Z#~F<,":AiEe_2g<n""tiT0b`xjuPSxBZ]R^[8T<Y][19pfFtF",7,8,10,2,skip
M{V3*8@e8;5maZq-x&H[k1tSFO%'Vg/#@+vCAc,"AMV|(?`W!kRw""Pu[Z:[]M!!Sw;ImTZJ@SUr/2g+|2r",3,3,5,2,skip
M{V3*8@e8;5maZq-x&H[k1tSFO%'Vg/#@+vCAc,"AMV|(?`W!kRw""Pu[Z:[]M!!Sw;ImTZJ@SUr/2g+|2r",4,5,7,2,skip
"M}I2/r#E@0VA|B#rS}j""L}Gq%#Gy'xK<!bhS|W",.~9@cc]>:8rn\wr.OnIZ1/~EnnO7fY[KqusWVH6&+c,6,3,5,2,skip
"M}Tgl.3C=z N`uKT/5,GN9vI<T.@1z.Wd\6]?M",W':fq }({:WN^f_EngW9@:FW]]w3aU_o3k]B8P-<z},4,4,7,3,skip
N%Y7O57+E@xn!Zv;;1~`p$_<b=Dm0:;&T)aybF,xW3\ucJ>G4k nYzce-<(R(d}QB_dleI+'~yO6LsSu9,3,2,4,2,skip
N)9F?M-g6dskaH?Qr\'fw}X7=Fi;/h82\/w <G,2-72Y_#@ L<pCp3<vJetT1Now}b6&#[<'zb}O-Z<_l,2,2,4,2,skip
N)9F?M-g6dskaH?Qr\'fw}X7=Fi;/h82\/w <G,2-72Y_#@ L<pCp3<vJetT1Now}b6&#[<'zb}O-Z<_l,4,4,6,2,skip
N)[oIn>OFwgr1S!X\5NwD73y'q%-#w@CXD#$@c,"=U./6:JP&)%hv$B3Ex5#mdCraUOK#zT,Ea=G-7.Qp8",5,5,7,2,skip
"N/+sY]ZVJN(GQpF+_vZ{Zi^H@7,/1sY($(?2pv","(|vvDkfg2R-XS'7wz6P""""(.;DVVS/a][p`ZF;Hs^vf",4,4,6,2,skip
"N/+sY]ZVJN(GQpF+_vZ{Zi^H@7,/1sY($(?2pv","(|vvDkfg2R-XS'7wz6P""""(.;DVVS/a][p`ZF;Hs^vf",5,6,8,2,skip
N4V.XP=9]V^YTq@f/DMJ?'cd>x=uLOSK]x/u!~,"n{k{P~""}$chUcyCu]~Q\a&pnO|_A ""3`g2f/5Jc=;<",2,2,4,2,skip
N4V.XP=9]V^YTq@f/DMJ?'cd>x=uLOSK]x/u!~,"n{k{P~""}$chUcyCu]~Q\a&pnO|_A ""3`g2f/5Jc=;<",3,4,6,2,skip
N@Iy40V*~j)2y'Vd]cHi;SD6AyIf0)>V8cg;`j,|wYWI.{}bq.Oa9H4%+xhkldtX=R}au={p73BLoyH`o,3,2,4,2,skip
N@Zs4MvWA60d+0$C;gH9U2gLZVya/m!FIt3`gr,MNarw:`**S}M<<@NZZH7}48~BIOj+X1R^_i} lJ9<R,1,1,5,4,skip
"NEt!'Fz'@#[s]o-TWd]:,5[&&d<YkyhDRPOpp$","g4buZrmQ`ey""Y*3,KJh4>12 ~?=:DDjExecGQTbkR_",2,2,5,3,skip
"NKsN,]qg&CVW2Z.-Tce[rxxC>IXn9Sd|4%sj<1",OEN}CF}2;g-).>ki>8Q>#acEW#qed!o3l*\Vk{4!x>,2,2,4,2,skip
N]W$?B4-llJ<Sgp-gJ%w[[xw{<C $W#:Clf~oa,"o4a+Ru*&j7g_{i1vEDq""nrHXOZ QPa(|Mn4#&NB]TK",3,3,5,2,skip
"Ns'OG/IYh_j,|!|sxF}tT=LP/\2Qkq3+~htWr)",W^ qSc$MEH$/z HScYDK3irtdsOA-ND1./]%?*uIMA,3,3,5,2,skip
NtNg96p^1WOz/G.R02#M-e-QTzF*zQvl:i;i]U,t}}W<c5`*M&pr^2.!G$[lAe|ycUM!a_1P%U<of(G3;,3,3,5,2,skip
"Nu""A`+R>pm]K3'-l-+Y:_Fp=Pvzs-]*-Tv*[ez","wbEL#4_)=BxJ""Z%P2LbLzA~YAykF|4n(BEjY2 Zq=T",3,3,5,2,skip
O$EnIF7:lSp3Dpe\54Fw|~7-xd#]PRhvW_x1&C,&K^EdQ4i]1b[f(6KJx]e\.MC;k{6y*#\Dc^Gj]6z[K,2,2,4,2,skip
"O,MH2U`*USQ|(JqKm f2FB:n}1b\W.K:8s2=6h",br17` L}\uUR4_v<)H`[+~y:e$UqUZ}{!2N\#]:xNF,3,3,5,2,skip
"O,MH2U`*USQ|(JqKm f2FB:n}1b\W.K:8s2=6h",br17` L}\uUR4_v<)H`[+~y:e$UqUZ}{!2N\#]:xNF,7,8,10,2,skip
O-Gmug+S<\yQ&+KpzGt-2k^.9d\Mc|KD%e!$/B,"W?/0V~LMQo|BXd$?0JA/y 0?6$>UU6O!uz!s""I/EdS",2,2,4,2,skip
"O3|:X/I{jpD5;RTb""v]yj6+34Iz:g=5WU~U-""2",[2uFqz1?z|#bzI*9eRK L.j%qdz-z^4]Y412yV)a!a,11,9,11,2,skip
"O3|:X/I{jpD5;RTb""v]yj6+34Iz:g=5WU~U-""2",[2uFqz1?z|#bzI*9eRK L.j%qdz-z^4]Y412yV)a!a,12,11,10,-1,reset
"O=^?@-.ry*a{xp',aGd6k""i%OG\$\wJp2wp`P4",c!{6!K0VX5uu>!{y<\ahc:Oh[6&%F(#U;g5zoAR^RD,1,1,3,2,skip
"O?Ty6O,}T.ib=u$+OM+zV@o=pQ,R/E$ns~~iSM","yI9~n0Ln}[&q,y&_X;EaRHayLvrwZq/~ 8zWCE1.~!",9,9,12,3,skip
"OENg4,U++R2@i/AdSh'^WgYEwd#XAx|v5_e.98","^&Y.lf6-;5<ig24|Pys?Hjj{MkL,RW#T+Xk(^`{Vvg",4,4,8,4,skip
"OL:XV={*!I\%qF,$-e;Xf$<I$ub}K=j:\ g0)e","qX7h_a%\.eTTx(m`<=z""Qny*mb7~""+8IWk""S!R|eDT",2,2,4,2,skip
ObifzA=r`Z]PjWn@$L-d5@e6OUJUKL<3LIFqK>,".lSW@Us iSUi<s5G<en""~+x<^(d.+x\;6kh fQx|,8",1,1,3,2,skip
Ocujv1gig7|5EmV``Q?KEi`LC5)AB&iMBY/>lK,AMG!]cCljaR}R=8yM69xU:/79\z{U!}NeFJ/4k\7}@,1,2,4,2,skip
"Op?Xd}89^/WX},s@`}CeW=N?1S7STGR?l\W*T;",MqDJhgb1U[Ce>FiqSTWT^#)oi2B8$`eK#N|w5@J+E@,4,4,6,2,skip
"Op?Xd}89^/WX},s@`}CeW=N?1S7STGR?l\W*T;",MqDJhgb1U[Ce>FiqSTWT^#)oi2B8$`eK#N|w5@J+E@,7,8,10,2,skip
OwS2Y^T8W;_ in*zqj_d_6j1?pO`ox&dX+P7W{,"wTUR1.^Rpgrr7~!f,1 *h10`C/kC3=Z;>;u\GYRgg7",2,2,4,2,skip
OwS2Y^T8W;_ in*zqj_d_6j1?pO`ox&dX+P7W{,"wTUR1.^Rpgrr7~!f,1 *h10`C/kC3=Z;>;u\GYRgg7",3,4,6,2,skip
"P;tM-!@/.v_/#3gRV!XpD^'L*>$jqyY$g""l)=T",",;rTI|dx]vW7QYMnEU,VMHe""#5;/H>*{*2oBbn<_\1",2,2,4,2,skip
P<SK>i#4ZQ#?o(nIoT5ZUv%!cX'uE?<nyT_h&j,"f:;+HTX""aT7~.H6sN5WX/*,AT:#0w|pxBfH[I~0DDf",1,1,3,2,skip
"PI2(8PTjZ+B V%(^tJQk\T_4q_*a'Q>GC.8F,~","coUjC`B|lI%].3$:2FSszyYNu!_.K;&;E[o>7N,W7(",4,4,6,2,skip
"PI2(8PTjZ+B V%(^tJQk\T_4q_*a'Q>GC.8F,~","coUjC`B|lI%].3$:2FSszyYNu!_.K;&;E[o>7N,W7(",5,6,8,2,skip
"PRuWZMN(g,(yz&WGY1odJ""8Y3YzOsq0~O)JTJ/",z4^;tL{}yufja ^0;@Gl:4cAgXJCi.v`FUEwY8XRSk,3,3,6,3,skip
"PW*6o%O|' %B1E:_dY@OC6+@;Hl7pB,Yx8Ckk`",d}@d|gQ]=W0*QpYD'u!VOyumTUb_`(~|431@Lk;_zu,3,3,5,2,skip
PWy^D*;;>^)#tm]WeoxUc_+y`:z$zts!8p=r7b,c%t9L+YLx6IkT8*urdv*gBwEdttC%}eIV]94LcNN/{,8,9,18,9,skip
PXku|dZSqF}.]r>o}.U~X!/!%Vc9~NFhO@e@IP,^ynm\{*JHsFb;q:\I&9L8@@Y:qg%T1IISL?^GI-Ly8,3,3,5,2,skip
"P\`7,AC,wS=u6q,gmN|*|%B?B}\z_Rj*A77HTc",Z7Qx|.}`\8o]~YtF[ijcoe6e:s0V]=dP^Lic`j/!_o,2,2,6,4,skip
"Pk""#bbU-#!.!#z/eiM4@\mNtZf}pDO6x~!>5*'",jqp\?.QMp5^<*\c$3a0o(XXU+g[Ky\Znwj+T|:K6ag,1,2,4,2,skip
Pr%7:'Rk:vWb!E:4s*AiVl`Q FVhkhlwLUB:Sv,e'T&%bE]=MEsuZ&4xGY%a5j?5P1:m1C[)hl0=oE\'F,2,2,4,2,skip
Q2pB5p\Df; e>oE]81nz>gvO[?%L6k 2i6DR8Y,"=Qx5^'L'CP#^[p$osy\iAH`s2)VWMt""Y @Y~E35|~=",1,2,5,3,skip
Q9 q|{3CbSx6wD|Drg@)p9B];IMxtCAiD!u@Uw,"VXZ?F?x9rP~Zff/_&^""Jt_fNprxp7?wd7GK""I$Rb1[",2,2,4,2,skip
Q<TNoc*RU%{0jv $/X}w|`k73Rn%nV\:'aNt5E,"Y&'6J3?CuA),H?jo854_jh.{OI,4!dy_z_e{""D>mD0",2,2,4,2,skip
"Q?\9X8QCv`;-By2hV$""ZYRFut[HA 7Trpg=xz2","w\O<O,ksDr)#P+E8H|.mS'16/ao$}/g zLRQU<y'!n",2,2,9,7,skip
QTWmqy+t'mb}PK'AuK@wM^|tw;`tu2B`9to8(Y,"Q#T:o=x]^9,7.SADF\bSc!}zFu{Vtx}&jon}:Xo4aH",4,4,7,3,skip
"QT`r(iD GN&,j7""GzHKVCW+{F;E% :NJQAi}hV",")`t(YY&@?xvE.b|GAT{,"".D+YG0opO~Cl ~X{|~[qH",3,3,7,4,skip
"QT`r(iD GN&,j7""GzHKVCW+{F;E% :NJQAi}hV",")`t(YY&@?xvE.b|GAT{,"".D+YG0opO~Cl ~X{|~[qH",5,8,11,3,skip
R Q[S2s e}(?Ol`gd`W4q+z885F jPE{ o&BHl,ktri+:S7qR~1\5@>%hWudt)K:IZ8j6|kU@9tgS rv;,3,3,5,2,skip
R!<c[<NRn7u%*7@WiLctCaBOPh#lxw <iN``VW,"9hN4$'$`Q=D%xq]'H68c-O+Hg?,u[#8\^KItP:|{1Q",1,2,4,2,skip
"R#y|e,}jB,~Mq:$+f~er}>O&U TEw-GlXj8lAs","]RZO,G~Il!g76/Oa@$G]zF-Wi0keZ2+?&)mH+'9Lht",4,4,6,2,skip
"R)Q)PR<bK_=zSmN^@&Dlx~TL""`Q$~rdG$:I1,]",dwn7&/[ GvMHD[j5nhsug-P$Eo(/VIs+JLF(Y qp7A,1,1,3,2,skip
"R9#G&l`IMCHZoU:A&>jRA&v[V35""<c [""eCPBz",f&k_N$Rm[e2gda4UBSqGMGa0FZ(FVx]TXGvZE+iJ%',10,10,13,3,skip
"R@^o$TDvL7""IXDiU=^RHj%~Bh!_w.RJ#vka=_y","@k2L0Iz^!3@&;>W-,JN?4PCRPW4w\AFhzf.(@rZrHX",2,2,4,2,skip
"RH)z&x9Cnq|2@qaY[""?g&w3FZTj6[FeXu`:`[W","foK9=7R""5k>\Vatx,cG|.Lo@]rN_P,T|)$^Nok@hl0",3,3,5,2,skip
"RIs0M2(LW.$B,kNjqRq]y*rg-}%6h&SZ2G[0X-","~AQ4%aP5P,TC,3{6""ePs@+DUK061oRV,3?w/Bu8fe~",4,3,5,2,skip
"RU}2Xw;_D3x).RXfB$izl0/a.y*""fX:_FOe>6N",`I`?<75IKhf}xUrqJ(u[E1K1&Keb#@7xpA\hDSTg=P,2,2,4,2,skip
"RU}2Xw;_D3x).RXfB$izl0/a.y*""fX:_FOe>6N",`I`?<75IKhf}xUrqJ(u[E1K1&Keb#@7xpA\hDSTg=P,4,5,7,2,skip
"S,c}T@s2J$y*!zDNEfCsFg/s}H|mN\?{Zy`w>^","v6IjNApmBqwTzR1UBB'On;c7?qK1FWm""M0-pS+d?og",2,2,4,2,skip
"S,c}T@s2J$y*!zDNEfCsFg/s}H|mN\?{Zy`w>^","v6IjNApmBqwTzR1UBB'On;c7?qK1FWm""M0-pS+d?og",3,4,3,-1,reset
S0!Heu>|f!tH$Naq#V(Fli|Bohaf|>|wq_+.LD,"4HDF>""LL7!XQ9T^fsBRJ|c`_ofC(!!8X*>>9;Eby~,",1,1,3,2,skip
S93;}43[s+<[_mU@ZV`l_*bzf7i?A!y0:d@+:=,"DO}zwNik`bIs_'~LZZT@6fHZ~SWKfJU$xmMT0\"" Wo",1,1,3,2,skip
S;V@r*Uz! -7qjUH_eSLh\TJ!l@j%iAWYI6s-{,"b3f^LB-n1++Nq,K\pm>5x-9yF3#%?+WmC)TL(i72Wp",2,2,4,2,skip
"S<wc4Nx7HC@]^TDN<nYA%`Dcx[m8[R]3z""r`[R","!MHiU/""jkG[|Z79p(hQ,9lC[l!|[ *y%ceV8cq2}1W",2,2,4,2,skip
"S=1>rW4zkf!~OpZY@#&:e=8""F2xReK)r^.z.O2","zV)KO@[R}sdJUB{5D1A#u""+U)jrHXol29+iL$:vh^O",3,2,4,2,skip
"S=1>rW4zkf!~OpZY@#&:e=8""F2xReK)r^.z.O2","zV)KO@[R}sdJUB{5D1A#u""+U)jrHXol29+iL$:vh^O",6,6,8,2,skip
S=e#QT[4/ r#S'=zI84J>f\1i<T/Wl3Pa<zE+#, rAUX $sYhRZ{OvEg.O5'^W;RVx4gDZfmpL>EC%3i+,2,2,4,2,skip
S?Bl1juw<_lmEtjCQB^qRf;dV@L#2j\;n_%Z_T,|t#\{4eo[A-eDQbJAqv4MP2H HgTQk'}-4$[..n=E;,4,4,6,2,skip
SU@$B$JbPUxzK^;Ih\Ow oWJ3I)z|Ij_lA}JfH,"h=O0muBuikl/HPNRb7A;{pH#ctf=$/%Rv&^S,ytPNy",3,3,5,2,skip
SU@$B$JbPUxzK^;Ih\Ow oWJ3I)z|Ij_lA}JfH,"h=O0muBuikl/HPNRb7A;{pH#ctf=$/%Rv&^S,ytPNy",4,5,7,2,skip
SU@$B$JbPUxzK^;Ih\Ow oWJ3I)z|Ij_lA}JfH,"h=O0muBuikl/HPNRb7A;{pH#ctf=$/%Rv&^S,ytPNy",5,7,9,2,skip
SYMML6HxH08dxiQ|M?A.m]b3W7Ltr3<COrCo;O,"zdwT,`7GZ:q?:7|m igP\.P<,A8/M-P8,B;oei)wQ-",2,2,4,2,skip
S}| ok}L@e7|\?rnc_Is2_dUA|Y2*f*J+j$>jM,"B7N{F<ZPZzhx^,dG6&R<w?mM@>=1txN[G54wDen\\^",1,1,3,2,skip
"T*KeR}L.cna""n0v{Z& Mx+c,W2VcyJ3'?iS>V2","jo56K-)(dr6!wk_?x&""!j9+LTa(P{K%l}3L@6=ZVSm",2,2,4,2,skip
"T54LOvRB7cX:4fFIsABL#\"";3UALN<`n<@~?Ho","bBAU,JDbH?nh""HpW+wq2S%I:=1t\kift/KH3|46P:d",2,2,4,2,skip
"T9U> {:4$j`-9mqNo]v-g|~G4~~34"".]ziA4Cj","E|$t|Q,p#'$P=5I5*]Ih-~=9WCeFRxL\aL4Zo(z{<x",1,1,5,4,skip
TXu5{%841bXGHx lA<x[!aMRBdx4McD6[/S6J|,"md0`y#`n=#i=I\""#""/\DBz:7`&;=(IT7(|Wer^zgi\",1,1,4,3,skip
TlZBbAa%(Xb32ZY21 9#([fa]_M*s>|OGw8pGG,"yA~dwmM""UD%d3l499E?uhrTEFkC!2ce+f!-j/?v%[\",4,3,5,2,skip
TzOU:]>a+ys]pYI`N)f99Vi[;i&}1SGiKt<qp(,zZeQe1gllDawBLK6pu<b%udWwb;^P/a{kGu8UdwanZ,4,2,4,2,skip
UL?cbdR^(0GuEW?{1(Y3A)}>w(b'W%PKD-T)@b,!$Rh$3(Yd<I)YMxbP/Sajg$:?%qvqV%RfFiI:_Czr?,3,3,5,2,skip
"UOrMj;.&r&XFW--B[v$qC6^B""=?dbB9#V_a5GC",*01^l&O`J&<**Q_gQvU:AlEq9e9Ov3z`kWEOyp8'2e,3,3,5,2,skip
"UOrMj;.&r&XFW--B[v$qC6^B""=?dbB9#V_a5GC",*01^l&O`J&<**Q_gQvU:AlEq9e9Ov3z`kWEOyp8'2e,4,5,7,2,skip
UQH_.1{>a+-MY+]$+~CM|:voIhajis~C+`rEiF,"fD),sSzmLj#.A""5qd~:rr+6*Fko9S[l7iVPTH~%8q!",5,5,7,2,skip
"U^C9oz6Px [vK1Dy>D$.>SuDa:e$C\E""m"";@&9","~+j{n)2v?u[q(iE.Bys""mcK0?PJFh%\'NuuHX%UuYG",1,1,3,2,skip
Ur`zHBb} 0w.-(~gf+Adm{pA<5=pYbE IJM*Qh,"n:-.w+oPF/(nOg2DY+GEHYA$FU&}0Bs""}g4i#kM:{p",2,2,4,2,skip
"Uu7""G>0fAjQ|e~sW""Z|x^Jt(][/t`sZ!SiHE)Q","\n]UK4:,4dD""woU}uJPSG""czL$SX`.}M$):aT81/n.",2,2,4,2,skip
"Uu7""G>0fAjQ|e~sW""Z|x^Jt(][/t`sZ!SiHE)Q","\n]UK4:,4dD""woU}uJPSG""czL$SX`.}M$):aT81/n.",4,5,7,2,skip
"Uu7""G>0fAjQ|e~sW""Z|x^Jt(][/t`sZ!SiHE)Q",wFD@s;4k`~|}]yss\e1lN)~rmefJF`hH>sUUDhAmc`,3,3,5,2,skip
"Uu7""G>0fAjQ|e~sW""Z|x^Jt(][/t`sZ!SiHE)Q",wFD@s;4k`~|}]yss\e1lN)~rmefJF`hH>sUUDhAmc`,4,5,7,2,skip
UxZ4sa4(j]SMU-|=dG2.5Q^QJ'XCUv q''RTC9," PTrs]WV~~xJ`$I1CS=LYowuAOQ""8.hMcSLY?0\0Cr",3,3,5,2,skip
V2XRx^d1\[{W:dyr^-.#SV2Nt&Hc!S{eaRp41l,"zL.aL9[JVe h]~k(HhCs3~i~""H1FnkH~Mrha}IO_@d",1,2,4,2,skip
"V3SH[1UzOTPV>?BfcT<hgH\xyn{!%oaf"" x!9E","Ve[7=W,tk>DB,TiTG -!O*_""B)h;!Wdr*;Odft_bB+",16,16,19,3,skip
"V8,nm dG0*@.Jk(m(L)hRac%cEeVLV5e|g_KQz","P}8PL(%aZWZjyJ_:%nqW#WkB`XXrV'O:""tZbWPox2d",5,24,31,7,skip
VEc2yR9nt{})]D]!K+W1I-nq{b<o0n8>=lA8Do,G{s8/?Do{<fXwm)xw!?&em?\Vc/TDsA=~%tN2]?6XF,3,3,5,2,skip
VGH4QQMH;M?uL()>rSA).|R~lQB)1Q`.S`1F5[,"RM'~6uRh}LA!d""ZjZkPqFA[5+IZf<~i-nSmHe}?63!",4,4,6,2,skip
"VIlN; boH<3m;zZykEa""j]kB""x,7+wQT]:X%9~","E+kP""U!4k<[s>*`D1{%3)Ag7RLHcu#>N}5?^%*S)Ug",3,4,6,2,skip
"VJi-Se|HC0l)-cc;6dAuz""!ch'Ef|(+IjN-m8{",V>@CC8aw.eJF#sE[.3V}#^p]'P[<fxcvnH`4lRT&4.,2,2,4,2,skip
"VKK&/sxwU-nN9a,k;swS""e,}E =v[8D!2ypZ2+","ov:cK.Z@Ow'jY|%Jf>B6@~Goj3CExSSWcj7sy3Zj""'",1,1,5,4,skip
"VR]tk,>0M/<TgIq/WFL %tmttjuq_Fc5SW#tW$","_'[)T,8\-4pt2tZ(CV=cI9m%LX|y0'"".xFazcN7NP ",2,2,4,2,skip
"Vc)V%>,MRtF&Zw?""3`~Bi`vN0Gn*t_:KXXkD+Q","6;""Tm>HAdzw].ZWIP?JBdE)Q5<1P)TldR0,=FOH:5Z",4,4,6,2,skip
Vso2V$xQTJGWcU+vM%A[J'6$Kyfogb;L$|Wt*w,"*~ Fz`HCYuf\3$rEi{Jv~,_"":9Jes($m+WUr@ZFqbX",3,3,5,2,skip
"VuK[dCqJhy""XriQ`"">:eH+XE3z3IE*v2pgOjo8",#BTEa%;.+M(y~U+fNC`~.Sb*ZHbz}2-Xs7hX:OXlgJ,2,3,5,2,skip
W L%T3iFEX(A/Q`c. ^r7r8 i$n\^T>k-f4w/s,"0Q/Tc{x6/=4;V6s=rS<:4[FK/M,-{e<]uWq'&o4""e9",2,2,4,2,skip
W L%T3iFEX(A/Q`c. ^r7r8 i$n\^T>k-f4w/s,o-TiR;5MvMnNH95<g<}nblX2$P[}!yn* 0~\)[@;r*,4,4,6,2,skip
W%uPWvDmb-;G!@>a!Sg|9.93GsD)!`fIsfp<dU,"\TkcQ/XD!Y2XS>WcPW,.F-6;SC:)=;2:6%mRV`#~ot",7,9,11,2,skip
"W&^:X\@&4/oQsT""3+<BD.Ys.^-~%U>Jyi7iH.y","rrDf4r1Jm6oH@AU""'RFpM#3eV`Khq|){$>ADeOe~(Y",5,5,7,2,skip
W'~|bbP-Ztvi<&pp)1OM5(#(GAXWkOWTnCIrNV,l;!>513vkqUCrEjzf`]z'84QZn&djby_t`:HR_i9.@,2,2,5,3,skip
W/9Cqx[f?kFodKOSBIxux~r|(/4i'e{lig~}1S,"4qo8QBUU}ibYI8`2(J"" 2AS(gLOv4$D M&*-m-<iRR",8,8,10,2,skip
WWf[bxl8X/2-EA_wem9>EJ=2+9KA818_>pun#P,"'VT)v1`|D ?=4r:rS<&UCeUhaqFk332W""BRGtIr%KG",3,3,5,2,skip
W]?4?C:Q&h*#FLYVhuVo.\7/zG!G@'lZ]_tp]=,"/?Mm""EPSVy[Z6u+\'$^oAB?13Z4PC3%""jMb,f?pb@7",3,2,4,2,skip
W]?4?C:Q&h*#FLYVhuVo.\7/zG!G@'lZ]_tp]=,"/?Mm""EPSVy[Z6u+\'$^oAB?13Z4PC3%""jMb,f?pb@7",4,4,3,-1,reset
W]?4?C:Q&h*#FLYVhuVo.\7/zG!G@'lZ]_tp]=,"/?Mm""EPSVy[Z6u+\'$^oAB?13Z4PC3%""jMb,f?pb@7",5,3,5,2,skip
Wb +4-<l}pa/8-I`}bip3kv#HIT8Q&qG<l6&dh,JQy/_Z<a>9z@2MM4a(<){2ye;|:M\]MIJ6%i$mztxJ,4,3,5,2,skip
"WbW{MnC(nO,CC;ub\w'0SFT )OY5eO6O4kx-U$",gG/z#V+D;H31HG'!LxebMLa<j:y7.f=~Thn&`.@M4^,2,2,4,2,skip
"Wg%8~ch9&JHM|""v9'ejwZq,W^PFgkCaWb?{;+,",GoSPA>LqKaV&Y#X/1:*YN9A0[iNU_~)!I4{`v\U6+Y,3,2,4,2,skip
Wje p[x%H-sMMzD ^{'M/{edK;5}~l!o![TK36,]N@B%m:IN*+oD0Gy\n&1704%>7PF+408 f@`|/ypsc,1,2,4,2,skip
"WkJ;`Zy!\q~HQDo^RMvkK-z3lX^,B5[qyWf-)r","h!rfrbWtFA@\O~c2hh,^\M}`5k^oI[dBhg\8Bl+IDW",2,2,5,3,skip
WnMRS-Af$dQQ1qi_fNu:Q}a-G/]upZZjr$DIG@,"R<kt7b@BfK*4\23v,`S*Kk#~S1Pkl0{/a@O-2X}9Mc",1,1,3,2,skip
WoYN{?1l\Dif'-EF~oF@O<C=cfT@G<.&0mb8dc,g6q:w+^t2o(::<nP58S?NfXhXaqS(9v;'y/@fZ`@U4,4,2,4,2,skip
WoYN{?1l\Dif'-EF~oF@O<C=cfT@G<.&0mb8dc,g6q:w+^t2o(::<nP58S?NfXhXaqS(9v;'y/@fZ`@U4,7,6,8,2,skip
Wp;k2Vk`D[<TAS%KkyExN]U]zO\_6=~X:?0+/h,k)Y W^><f_dG0nQgR.VCgZ+8egG+-fbGng/-krD_>r,1,2,4,2,skip
Wq'o-hZeS%21!^yKngW:`S-uH*kTg\^~tDVALd,"#K-v-PaR{NOF B~`&q""(P<CLD,m+ntJTiT_/ 8h2}?",3,3,5,2,skip
"Ws87N#?7oa0Z""Vx|#""-Tc%CjhL\-A!*Zs3:3+{","}%"".m3T$SW]NVh/;viUsEwpN3M/nxWG/'\>3$Pe9VW",1,1,3,2,skip
"X$y{C?=6h4//AX6niJ3L#,:Z5LZ]PA*?yLNG3:",J|0d\ij>Tv=;uEf 5}q*t[goqk`orw5j$nn+]WN5n[,2,2,4,2,skip
X:#[3oD6z 9*fwUZ_:.38#\$WGOB67vv1K+v9N,"c[~b:Oqb_uO7,2S\J-s$},X[<|@Hn,V~0l+3B$6N.f",3,3,5,2,skip
"X<@hpk.{a""VdH_pX'Z+F5tx96VAlE3}]v%"",Sl","h$UQ;S\(~FlW&R,i5%Ze$P!$5j9-XN9gKk'N192:;v",1,1,3,2,skip
"XCT0GgMH/p_36YJ8,GO#=mX_jz5+#K`ph$*g2Z","`X\aFBB^gQvJ'9|Sr)IPUGz,PI/Cdxp$iJj]IpW2D#",5,4,6,2,skip
Xb64]r(pUH/s21U$8^WZOW%WU|&;l5>hAQr@A?,"4Qa3,0M[=UI&quPWN?l1;`z#*J^X)V?y[oT>[{""]ay",5,5,7,2,skip
XmT7of<bx];]Ly$unVkQEu[0+U@y7RTr3RFqB8,"np%RD""d&cZ7o'MF=/c7A?@-_b2Wa,i(OSn1h]Z|EM]",3,3,5,2,skip
Xp3x<7P]c5t3~>o_;;Gox\>pQ^t;8\m(Svof|X,"+#QP+Eb&??_9vV{?PlH)zOD~H,lC{qS$#0>*qk$+PF",1,1,5,4,skip
XpwP2xde]BG%gtRA&J4K>nZ 9Zh'y1_$pyGqV>,"(g4Jqo)D8<q|jN{Z`^aVjH/o4?#4"":a{3;DX?H}.ku",14,30,32,2,skip
XpwP2xde]BG%gtRA&J4K>nZ 9Zh'y1_$pyGqV>,"(g4Jqo)D8<q|jN{Z`^aVjH/o4?#4"":a{3;DX?H}.ku",19,36,41,5,skip
XpwP2xde]BG%gtRA&J4K>nZ 9Zh'y1_$pyGqV>,"(g4Jqo)D8<q|jN{Z`^aVjH/o4?#4"":a{3;DX?H}.ku",20,41,43,2,skip
Y&h?>v~$o.|$Uw92AW6[n-}D:(x-#WlesCXB7w,"0Zkly$"" ,=i$hh:h{Gc`I*/o3?(9 \CCH""AlXeVFwS",3,3,5,2,skip
Y&h?>v~$o.|$Uw92AW6[n-}D:(x-#WlesCXB7w,"0Zkly$"" ,=i$hh:h{Gc`I*/o3?(9 \CCH""AlXeVFwS",4,5,7,2,skip
"Y+%\BdL0u[)=""&\Qx$,q2hbJ2H3q1{7C:uoL>o",cLSB@mn@[&IF['c`[:ByK_+`EN)xqF%{.pg:;~\L4c,2,2,4,2,skip
Y8yHWg<%:#\S1o6r:O*-kES)K7G?ey;^#mN4&Y,"s%E&yEmDm-Fl>B$ian""%sL.hukx[vz[)dDaD""dF:Dk",1,2,1,-1,reset
"YG2p;:3,+h@&#X@x,se_As/O[Wr<A%$5#BsB$@","N'-'EQ$m'|G7 @uGH)nCt%-6JM(gT""CH#c7>w@NWp6",2,3,5,2,skip
YRAe^uAtP^d$KtU-k\bN[qY?/ZD1$JK`++hetb,";#>x'Vjsb=Fs0:R8:,'h2`5@cC5A/heZ}\,^eZ2<BY",8,4,6,2,skip
"YbOBm6e,)6H0$b*=3""RAC<Ddt!mH7KU8'!F!Ns",j==S4R[ m#+jo=Pxb*Su_5(>-/E'*dy\3ZvM6|O}Wu,2,3,5,2,skip
"YbOBm6e,)6H0$b*=3""RAC<Ddt!mH7KU8'!F!Ns",j==S4R[ m#+jo=Pxb*Su_5(>-/E'*dy\3ZvM6|O}Wu,3,5,7,2,skip
"Yg*1MeC:X9""Kq(ezAl=ux1|UDCH85~""5`c2{*k","vd4D93^)2.,nw2F{{}jp:\<s{fGDfSx8SEN(&FItMC",3,8,15,7,skip
"Yl)m3Z |[?tLh/2$K!];6,2HJJD5g&g\npED9r"," LaYHr[O?6CLwSSKkJ[nR(r/D+|RvApZ%u[?K""]/t\",2,2,4,2,skip
Z8~<J>1IPdYu6[rsZK.%.mSC{7O);{ ?TSCmtW,"p:5_c}.TLXJ|w|Kbi@:I|OQ^e:!rfeOtocOqm#""EN{",2,2,4,2,skip
Z8~<J>1IPdYu6[rsZK.%.mSC{7O);{ ?TSCmtW,"p:5_c}.TLXJ|w|Kbi@:I|OQ^e:!rfeOtocOqm#""EN{",4,5,7,2,skip
Z8~<J>1IPdYu6[rsZK.%.mSC{7O);{ ?TSCmtW,"p:5_c}.TLXJ|w|Kbi@:I|OQ^e:!rfeOtocOqm#""EN{",5,7,9,2,skip
Z:M3RNX\]m?pGd6XTH Pct/cKz@QQ]xzW!h;aU,"0uAi)r!1""%fT=)4I8.2Sdd9/%^ef7,klb/_FTq@KVL",6,6,8,2,skip
"Z?_^J:hn;LW#}0YyIdvpJO""zLm=Ak)wc=Y_m/$",lvu~S.\$y`S{OtBEo8^Y0l@T/C&b^p=f@#9IJ~hn)0,7,7,9,2,skip
"ZAo*1q'gb?GW=1$8*1lR""1h7SLDC[P!u7]9)-W","-uSJ:$Tyg3d(-T476o/,|V|2Pfq|iT""bEXE%ENxHLs",1,1,3,2,skip
ZC*s%@:V{\W/zq*IQZl4XO`[q6c&I!F:|pAMou,"IFO_2=""&R4|W43Kzu+`g$4n7_kP$dtpgAeocY0=62q",2,2,7,5,skip
ZKlR0.3SHdAzzk3MH'{E!V;*sIA>`-MHUlfG+b,0f5_tlQv~g C-~xuhcm%:(6fW<2t`>;{uVzt5u5O8x,3,2,4,2,skip
"ZZPdJFD&mSc%O{b<,]1m'='Dmq]^#Q20*52NO]","\U)1zCC' X@7oTeF%gq#J5{X0t|Il<,MV1,6GOJ(}t",2,15,17,2,skip
"Z\.3p8IQ$Z""*9o4PB&!z\#8))'~ZRO+w:uzVUq","v<Rz\=m{d""=L(I*m)/(GFSpC=v/3n""4%V0d={rSBbQ",3,2,4,2,skip
"Ze,Y.>b|6""<g/5L@>'A{:w!2]]<Fi=/,s6~bR&",")AO$<=Iy.ImDNvd\ovC0kflkw<\1,RvTg(~Yq;OTd0",2,2,4,2,skip
"Zh<^L-XvmHW>/rnD,z?(0'mC""fWNvL,c;I3-EY","W,t""(rw^yjngs[DG:Ky%7ZepeBH**k<GiVb-_o8q !",2,3,5,2,skip
"Zh<^L-XvmHW>/rnD,z?(0'mC""fWNvL,c;I3-EY","W,t""(rw^yjngs[DG:Ky%7ZepeBH**k<GiVb-_o8q !",3,5,7,2,skip
"ZjPeyP!zG[sF#o]M]u""[nd0VOLm*tgj7D|#~&k","?Pe_b""D].`jqvy&5!^sVQj14*)j{c>nS8a .O|fLv5",3,2,4,2,skip
"ZmC|PXj};~=3mlYjG-Ulq=""ak>}C*a)F/9E'$r","yR&@nlmk!p2Il1R-+2g;b~!azrA/pZbI;?0,'>#wNk",7,7,9,2,skip
"Zn'Mr2Vz3ral]R{,O4Gbn+~~ECtjt0?V+/0l(A",L.L-7Wfdp$uHZ?uRRzZ(=bowGT{#Ks|JR_]+bxUwAp,5,4,6,2,skip
Znc[CMo%:y^LOYqtdp|!'Yc`VqJh]`ZhSL[tmi,x!LE9H| *..|&zQz-7+!ZwIsk/[|J/dS4#JtvM@t$R,4,7,9,2,skip
"Z~/cv)JOH|XzxE*%c{^!Csujn#n%#F-pO^""R]7",<4%O`(\8:F;!15t~qd.10l`8:=C~Tq$9UX7fGel0+g,1,1,4,3,skip
"[+a.ZP14[=hB%;Zg_""WA3Rqawb}9K!ta87@`d,","y7u9e(g)UEKbHX7'zY,PK0dnOB=0l#':!B\<(9.33q",6,6,8,2,skip
"[1YMUQG}J=;Dz4rIwt4|mgZxmr^%T""Xgv[F7im","|0iC""8w-mM^Fsjr%^.&_'~'db44?KKT^{>9h  *Q->",1,2,1,-1,reset
"[1YMUQG}J=;Dz4rIwt4|mgZxmr^%T""Xgv[F7im","|0iC""8w-mM^Fsjr%^.&_'~'db44?KKT^{>9h  *Q->",2,1,3,2,skip
"[8,s!f.qt9~)}yJ*,4(\;g8yBS hvj;]UejX=V",7xK(+S+llKY-j 2t{*GRjw6W|D[woTP_{j4yH28p5K,1,1,3,2,skip
"[8,s!f.qt9~)}yJ*,4(\;g8yBS hvj;]UejX=V",7xK(+S+llKY-j 2t{*GRjw6W|D[woTP_{j4yH28p5K,2,3,2,-1,reset
"[8,s!f.qt9~)}yJ*,4(\;g8yBS hvj;]UejX=V",7xK(+S+llKY-j 2t{*GRjw6W|D[woTP_{j4yH28p5K,3,2,4,2,skip
[9E?o5n!|0)8&Ej!%AA]VVi(ha6Ks]|`KfS?v',_XIg9_{I2N*H:fxn[cE/VeVU&O6Db79E='L<CE@$[?,4,6,8,2,skip
[N6UGj#c[ia&`=sLaz(tK~nj:9-fueYYCE+r(;,"5fPhV:Bs_hqvJ[6Oi6'6""|J%Minx5w)P |xi5NT#ck",2,9,11,2,skip
"[aFR|8h'ZV`3o.y9mlm^""LS?nA~GcdEw`8T)4q",\B^({ %2K#A~}3??$Ox*^[6 MR@2g6TVz*c='5b`C[,10,10,12,2,skip
\.X!o`6<V}Sh;uH]q76G%JDxk{hR{m^G}}LO4V,~`+1czu6y@l3$c5_x4^^X=gQ1Lj\3~*'pE(t/d[1d7,4,4,6,2,skip
\2p_&D;[d:{_h|VI%4mde8CGmTqAmRAGhF#2ih,"CZ<a*&&Ojq-kQgl,N4(H=\fw~^7Mf`Y5Ch\/g2qasK",2,4,6,2,skip
\?axXxZHMi`Tz+c|wW+L7Mf\0)RcCAc@&ANZM[,rcsRK^_><bvgqoV//PB.TpAygfP3*~e'zwuPuy}{24,1,2,4,2,skip
"\@N6v&[\vowYj({%jD(V+KSjs pQ^@MyG>k5,<",k5=tnpFN%jF|8cyK-4HOYTH:;b1jxp2Nm^Ui|or)wF,1,1,4,3,skip
"\Cuex2 ?p$~c+;Yvh1>wqohR]+D64_Uc29"":'{",s~jjDtA[yOA`4VA81E;|^G}]jGM|l~Yg0zS)5G^]sj,1,1,3,2,skip
\LrQ`rL@d*^)6V5g.uR +1v[B33ZYgWF 3-mN(,g-2]}D:\M92MUdn^QAs;y?iWd]+khub8jQC_HYC|PX,11,11,13,2,skip
"\O)^5P]<afMP.3X}u1b~m62n%q#^:Aj,!<I5N5","O_HLyNTj,3vBicgc""Xk""65\=m6P36CO}|X1s8`zks,",1,1,4,3,skip
\PSv`kl7j!HaIXfQ*d%r Z+01ZHv2qU@d8sd!U,$E3Ik\SPwWwne3jNkOvfmfL|yIGN6 B7pm\O]5.;li,3,4,6,2,skip
\U%'3t#zzx1?VK|~8belnXpQG:&B$Lv<*M<l}8,]?(#'CqZS7$ :RIs!ak(~n!}|cfJJ<Dpy'Sx!heB{H,2,2,7,5,skip
\U%'3t#zzx1?VK|~8belnXpQG:&B$Lv<*M<l}8,]?(#'CqZS7$ :RIs!ak(~n!}|cfJJ<Dpy'Sx!heB{H,5,9,12,3,skip
\U%'3t#zzx1?VK|~8belnXpQG:&B$Lv<*M<l}8,]?(#'CqZS7$ :RIs!ak(~n!}|cfJJ<Dpy'Sx!heB{H,6,12,15,3,skip
\U%'3t#zzx1?VK|~8belnXpQG:&B$Lv<*M<l}8,]?(#'CqZS7$ :RIs!ak(~n!}|cfJJ<Dpy'Sx!heB{H,7,15,18,3,skip
"\Y2`G/MZ-#GC90wx$X""e<F@~EafOBA|R'=?:bT","V)V/k-XhO=8s_.""~.uD:Gz r1p|5?Q^A^2F%YLNh3V",3,3,5,2,skip
\`{s<L5dV<2W6SdVBy7djlH~@'A`&?F9S$XFB ,"-C.6kHN}y$ms^P`Ad<!1';ai3""'u'y7rHZ/:=|ai{E",2,2,4,2,skip
\`{s<L5dV<2W6SdVBy7djlH~@'A`&?F9S$XFB ,"-C.6kHN}y$ms^P`Ad<!1';ai3""'u'y7rHZ/:=|ai{E",4,5,7,2,skip
\x!$?#II)v:'hcfBc)TN6}Vj~)>MA(c=k[JPR-,"Iy;mYVoJIn !6P2zd6;"",Mr0=X)1&ult""7HDfCM]U<",3,11,13,2,skip
"\yeMG/cQpW&3:Yr<f/v,]mR~\`ZGd;X;q]my8i",TBS8~;Wo?*/tqFu|06$)5:h%1r7E@W>.GBzDTRnOZ],2,2,4,2,skip
\ylU0B{mF%-|-GYM0qLC7HF<|0U-'6@5:$(u|*,"PrWo/m5[""{D*&?xY(b4*zuUK!mGUHW,ARB/l\_SXsI",1,2,4,2,skip
\{P|oPqdUF6-iL4S'M'9z1cnB(+0pVTjbtegbY,"I1BGz'j%Hy\\4d5BPFIIv>xdhz}-a,x'3rY[sfXJ's",2,2,4,2,skip
"]/wyOOfBQ"" I(W(~?b[*2ePF""sXjj^n3FHBPgm",pmADQ'sY{i$0rAj5E<y5V&fsc-cB|&CK{9>Lt-?7_c,4,4,7,3,skip
"]^4y?<#~UDCNEf_J*fE@s""vVVF!5UYC/4uxRv*","bO{&G0Vn. 4 ""Wk|20LLUr@K$lO3C-tGYWq+?q~WiX",1,1,3,2,skip
]a4DN;}koKcktf[s9mC6U]gmE%v6SRLxdW+~[Y,"0e)08$]Cdn4;f[FWQD'Dg{L:IR+P7%eFgZ,r<@7E8E",2,2,11,9,skip
]a4DN;}koKcktf[s9mC6U]gmE%v6SRLxdW+~[Y,"0e)08$]Cdn4;f[FWQD'Dg{L:IR+P7%eFgZ,r<@7E8E",4,12,15,3,skip
]a4DN;}koKcktf[s9mC6U]gmE%v6SRLxdW+~[Y,"0e)08$]Cdn4;f[FWQD'Dg{L:IR+P7%eFgZ,r<@7E8E",5,15,18,3,skip
]m_aHM&^=ooXlp}p_vGFgYuzY W^l'I_;rZzj*,*+dZ*Mn<oDn{w^/:ByPg=iI]h2xZ;yB)?]c[2k~MsG,6,15,18,3,skip
]sUK/'j.c7[!|9FwsO~M:;:FR:v;G&L<j=s_C-,"43=aJ:hijO30T5ber~&UHLKz%!]""JtcL&&|d,R!W^~",2,2,4,2,skip
]}k)(dPO%XD22f:mPot OgQz=O}QtBQ^xJJ?Z@,"!o|96sr,{yaY?|:P.HRB|*GgUoXH3tk""~]2/$jVG,9",6,7,9,2,skip
]}k)(dPO%XD22f:mPot OgQz=O}QtBQ^xJJ?Z@,"!o|96sr,{yaY?|:P.HRB|*GgUoXH3tk""~]2/$jVG,9",14,16,18,2,skip
"^!}6p$eo:#6VNj%;T_byo6,zP{d@&Ymp)""S^vl",{_grb1g5l3MgwLs:X8Rh*%25ls)-:/uwo2r2CjA(s0,3,2,4,2,skip
^)IxD-YLk-(`* tgh`YdWCxi}1b ]R.>BWo60`,.p9|(0K8CfU1;QS+m$*}=u2i$/vv37}w12*>jN8lHX,1,3,5,2,skip
^8)E:|k{^D1$?y3+.cOAn@n;bq-m?Q<dDmN9AS,ND]$v\z~:m|Qpuy{wC8%BG^ZIFXQ8F2Wzy[0GW|Mon,4,2,4,2,skip
^:*{4yd@G1XBfjLnMN+ZuiN<\uBB.w}T6J_;Q5,",6}&IX_uP{LZFZjYRj]&B?ZbF?@M1jtHDJ~`VNAT9R",9,15,17,2,skip
"^<f;r7|,V253NJ{3@,bNCd0_thmt7E*%Hj0?2!",(]GP4%<a)2_*Mz'mb)0:6{e^lbK+>~|2CTQr9KoSbA,1,2,4,2,skip
^>U;-@lQEv~~yR7#2qlZL8o?x!+W0@{Kr@Bg_?,"-A~%.zXj,X>J8o`4wg32}~UOQXvR5\0V$C\aAe=eX<",2,2,6,4,skip
"^>}Xg}+72>H6zW^l,{hs:2hzc'UgY8{lTA2nW^","8_C+g[f=la'',)'l^6.']c,>#[:M%wfDX=e$1hBV!|",4,4,6,2,skip
^@BSShbC>Axy&RXJ2kVPKXn/J9\0mY}oz!0\X^,1b+dXIs/?@K5g] NV[_.^s'4ccP#\KE#)L}G2yK&d/,6,7,9,2,skip
^@BSShbC>Axy&RXJ2kVPKXn/J9\0mY}oz!0\X^,1b+dXIs/?@K5g] NV[_.^s'4ccP#\KE#)L}G2yK&d/,12,11,13,2,skip
^@BSShbC>Axy&RXJ2kVPKXn/J9\0mY}oz!0\X^,1b+dXIs/?@K5g] NV[_.^s'4ccP#\KE#)L}G2yK&d/,14,14,16,2,skip
^]$t:jJZSCYM$yt]u|!f8MGg_lFI}Frwh!;h>s,.xqXBF>owl4?: YD2~RK2x<Kh=>{\/:wY\A!&?tVei,2,2,4,2,skip
"^]D,%V""st jS&*D,OuCXr}OZbTvA0T}""Xg:^:{",qwuu?LXx.0yH.r6aO(Q8>i{dBpvc n]&ZHBU;YwsR],10,10,12,2,skip
^f]@X7< Rss6cim= bf^9}[v>b/kB`(1[bI$tw,"e2R:Sik>:ud*bD&=nquS=JY@k\_c+buQKV=}<aDN_,",2,3,5,2,skip
"^|ZN!,yz8luY1B_frG(||1H:EKY=| ,5yMjcku",_jd+ :G+(m-UQI67Q1%q]Ho^8Bt|@C$8[6]HMx':OW,2,2,4,2,skip
"^|ZN!,yz8luY1B_frG(||1H:EKY=| ,5yMjcku",_jd+ :G+(m-UQI67Q1%q]Ho^8Bt|@C$8[6]HMx':OW,8,9,14,5,skip
"_!O/#AGLBKCUJe6~f9p8h:rZfu$L^GQ;""RiC""P","|cx~5$QdN1X$rA)>p q0'<G[9@U,W24:<g4aqIX:^N",1,1,3,2,skip
"_GI(aqw@e:[ND$@iL0ks[30+""I]'-FImm*iGuP",">Q*ZG-dzCemNc_:9/89x1;ph_MVcJ~KATue,6-@p/i",2,3,2,-1,reset
"_TB):&/e;$(""D\@T2d*Z(UeZ[?'0u*!b*&[y1.",9 %4tZaE]!^Rt7Fd4p3&wLrJXw)$(\@20Y*pl=9k5o,4,3,5,2,skip
"_Z<GKb,f^=#6nQ2o?2_J|M:iA-i15/p%X2^""bU","f]W8tnkdK<RqGI'AQ|unt4j,iR|yrB""YB{ke-g~syn",8,5,7,2,skip
_vAdt]TY~}rM2Z9m%'IdzpSf`@8F8?i?Ew`34F,i&6~wbCr;dW@bi*<QqyM04U11S{fa 79FeGgYY(p2^,4,4,6,2,skip
_vAdt]TY~}rM2Z9m%'IdzpSf`@8F8?i?Ew`34F,i&6~wbCr;dW@bi*<QqyM04U11S{fa 79FeGgYY(p2^,6,7,9,2,skip
_vAdt]TY~}rM2Z9m%'IdzpSf`@8F8?i?Ew`34F,i&6~wbCr;dW@bi*<QqyM04U11S{fa 79FeGgYY(p2^,7,9,11,2,skip
_vAdt]TY~}rM2Z9m%'IdzpSf`@8F8?i?Ew`34F,i&6~wbCr;dW@bi*<QqyM04U11S{fa 79FeGgYY(p2^,8,11,13,2,skip
_vAdt]TY~}rM2Z9m%'IdzpSf`@8F8?i?Ew`34F,i&6~wbCr;dW@bi*<QqyM04U11S{fa 79FeGgYY(p2^,9,13,15,2,skip
_vAdt]TY~}rM2Z9m%'IdzpSf`@8F8?i?Ew`34F,i&6~wbCr;dW@bi*<QqyM04U11S{fa 79FeGgYY(p2^,15,20,22,2,skip
_vAdt]TY~}rM2Z9m%'IdzpSf`@8F8?i?Ew`34F,i&6~wbCr;dW@bi*<QqyM04U11S{fa 79FeGgYY(p2^,22,28,30,2,skip
_vAdt]TY~}rM2Z9m%'IdzpSf`@8F8?i?Ew`34F,i&6~wbCr;dW@bi*<QqyM04U11S{fa 79FeGgYY(p2^,38,42,44,2,skip
_wqO%;3vlnB?4R;C/_DLbq3r8*lL38LoJu@yhg,"C@8vrz21nbg#]r22V%X(5]OF(H21[2DK_""1H\j:9+V",2,2,4,2,skip
`!D3bj7av&Qc4uz4[$<^@Vi~AM1nJz<d!uqG*G,[x^\\u(C(2}#%XD]y'H=mi&HV> x'ECBjlIxf?t0&[,5,5,7,2,skip
`'3d$4zx3JrOACcy-g%WdV@J5D^]9c/LHK:C&@,"s5_/+V;S*5WN*_k 2Ucs>c2a8>[%PcKp+D""`fDFQ,K",3,3,5,2,skip
"`*2J$""]72&XXlx:rsDog4?:STs0Ym[PLJy!95x",;wi-T](whbRU$/K*x|>~P!{P9Nq:(3RNL`coj:R 3i,4,4,7,3,skip
"`*2J$""]72&XXlx:rsDog4?:STs0Ym[PLJy!95x",;wi-T](whbRU$/K*x|>~P!{P9Nq:(3RNL`coj:R 3i,5,7,9,2,skip
"`CKtAY8.dud?Tvzm""!o7Xd}^UBbA!;esVNl[IM","v=kj_B""U}Sn{L]=si WKeLhBS>+m!0^n+.bTnT`.@]",3,3,5,2,skip
`WVebu-wGiTr2$YMnPVsv-;5Lm@GJ`$Y]g&C//,"ND6p#Lbk]+7s""N&+YD)!p{#FY}@EZ-tDCe9[HX\aJz",2,11,14,3,skip
"`]khkB->K];i5h&QAb>dA;WXW_-9""S"";o]},G)",bSHS&/:2#-;JXznGEU}KmnJ><|SUtX]Nf{pdYWeU.Z,3,3,5,2,skip
"`]khkB->K];i5h&QAb>dA;WXW_-9""S"";o]},G)",bSHS&/:2#-;JXznGEU}KmnJ><|SUtX]Nf{pdYWeU.Z,5,6,8,2,skip
"`l;S>MJjd[1e-z<r<(g]rfe!,e;/mWP1H4Rn{.",").|`_q568gp5\7{ss9c;rYYhnZOI2,oz9^[rCr-"":\",1,1,3,2,skip
"`l;S>MJjd[1e-z<r<(g]rfe!,e;/mWP1H4Rn{.",").|`_q568gp5\7{ss9c;rYYhnZOI2,oz9^[rCr-"":\",2,3,2,-1,reset
"`l;S>MJjd[1e-z<r<(g]rfe!,e;/mWP1H4Rn{.",").|`_q568gp5\7{ss9c;rYYhnZOI2,oz9^[rCr-"":\",3,2,4,2,skip
"`}[~A{,/um@yYWyiGk:}l|uj'(Dh}pgJVOJZSc","Re[zjn""!7|)-Z{tZ""i`(/L#~4\D=3jdC@[Kk8:1Z<^",2,2,4,2,skip
"`~<HhAbT9Mh&OC&kD$x4*3C[%*,b) {0+A2~,s","f#|5}tPv}t~]oP-L6D|(+""laUNc 3{\I<!{|&#/>;/",5,4,6,2,skip
"`~<HhAbT9Mh&OC&kD$x4*3C[%*,b) {0+A2~,s","f#|5}tPv}t~]oP-L6D|(+""laUNc 3{\I<!{|&#/>;/",6,6,10,4,skip
a($|xPp0e3nJgO)E)jR>_9 [[l[hg=bW/g~}/K,LQWmSSgKxN (pwb#5FJ.r}+|wK#%W*.\g&F@>q6=1o,1,2,1,-1,reset
a($|xPp0e3nJgO)E)jR>_9 [[l[hg=bW/g~}/K,LQWmSSgKxN (pwb#5FJ.r}+|wK#%W*.\g&F@>q6=1o,2,1,3,2,skip
a*]1Dj? >\16i8mgEBnF'yd*-H$odiB;[g$c(',"~""i8-*Z5y^:c}g%wJZ82I^G[3z]]vSi|_Ui\\z-lN(",2,2,4,2,skip
"a+iAuI20_G]|$,=Zr+>W?$K+}Q,L$%y[v,r(MM",4L;d+KbafJ%]uUri`?i6reTe<}$w`uy+}h6>)`BEF.,1,1,5,4,skip
"a4TCn.5\#VCWWq^]&SfNG|<&%cX*[,tf%ut?73","M>t""-Gl6fm\g%4dWZShC;aW-k T-HOrUTa0qcu+un8",2,2,4,2,skip
"a4TCn.5\#VCWWq^]&SfNG|<&%cX*[,tf%ut?73","M>t""-Gl6fm\g%4dWZShC;aW-k T-HOrUTa0qcu+un8",4,5,7,2,skip
a< s*Uu]8}}UQfb@`{16AhLC}I_>9mtu+KFooW,Dr:rt<(md&cpdk##*R&1L{8AVzL3]1P\CX^748gR&R,3,4,7,3,skip
a?:lp9w;7h$`l*K<y7;mcX)p;b!!_X#lXJQt[?,">h<""p?YF9O!<!{%Ke*U TS](15wM3+-U@agZ<2iM1U",14,10,12,2,skip
"a@3iGH/_$l2xmI--rs_Mm?,1Y!F;)q{Kz0XuYc",O>CP7Iun!Sv4V kzQT$ITW 4Nh#M|PYNjp`'0tVgvj,8,7,9,2,skip
"a@3iGH/_$l2xmI--rs_Mm?,1Y!F;)q{Kz0XuYc",O>CP7Iun!Sv4V kzQT$ITW 4Nh#M|PYNjp`'0tVgvj,9,9,8,-1,reset
aC4vO+062$rBts<t=h;i_O3U^Z-*?!Gj#p*k)*,_]-[XqeR1D.hxZm]'>K-O7x{)rQF]jTjHXC*r;rn*M,2,2,4,2,skip
"aP#'f[QH{6r3X(,`xb&FUP~'A'V#Uv+-Il=E's","%mpg\Tdncu.s7469iJrIzaxX/@|?y~$#,>e4=g1*Br",3,2,4,2,skip
"a]~:=V6W|^8%UL1i#_vfTJJE<ZH"":!lOcX`)]H",akUA!]4;SG$]DX;<%m*.E9pZEc8XxnnMlv%mQz2n.`,11,11,13,2,skip
"a]~:=V6W|^8%UL1i#_vfTJJE<ZH"":!lOcX`)]H",akUA!]4;SG$]DX;<%m*.E9pZEc8XxnnMlv%mQz2n.`,12,13,12,-1,reset
"a]~:=V6W|^8%UL1i#_vfTJJE<ZH"":!lOcX`)]H",akUA!]4;SG$]DX;<%m*.E9pZEc8XxnnMlv%mQz2n.`,13,12,14,2,skip
"aoY[\xC4&w9b""[/Kq/**shvSURr}y>M0j h0<O",9v/eX&nv&$>B=Z^}AN\XS<2B2~=OBI93<`BrJE0=qP,3,3,5,2,skip
"b,U}op""IE'U<O6w%ajP4j5k*|$BK$IH(Jv&t@@","+b.a*-:>TV7#:\syx.)L&PDHeJ F3*{ENO""Nf==3>(",11,11,13,2,skip
b6ZQmrF`'$aji3[J@=]\5qmL7X8_TTK/\}Z9A?,"d5|J96c5`d`5fB+Q@U""a~:HrTM '+}i>pkU2li6h$-",6,6,10,4,skip
b?;I{dLY^K1ucZO|K]S(rx!@]m~$1/i|[];1wg,N*rfa..g36+DA&uU{6;lc<4N_d9Xr!X8$C>>bnM>F3,2,2,4,2,skip
bZ! 1a?P{P`ss>KMnqXB/8=M_rOC&XRGP3D&FY,"32];@Dj%d6<UWeFA#p*RGTzRlx-SZXBmo:]@ln,h12",4,4,6,2,skip
"bmM|k-g;R92d4N;6ei>=,4V)lfqa}=nJ<34FD,","6^Z0xh'YCdzI)4y!&b+J{$jgD>V=Z;):-ZIh*D,`)0",21,21,25,4,skip
bmiyC8[/Q+W^f)M\;lPx6fQn7'5tyk(9WXP6L6, _nQbq+D*Tg:X$:glQ>rf+Ff_\U627Y@D>a0cMcx]^,5,10,17,7,skip
"bnY]F6ff`^Tva[""n.""d%Hx-B,P""l&K>'\I{i'e","(R@FJksk1\>si^faYPDzp?tyXccjY,M""5uZS:Ou$L=",2,2,4,2,skip
bos{_*b_Rx3b*&@ffs9GNei8p$5x[/QrA +:q(,"z3t`a$@pmp6;'zR;""AlHc2ukXxHB`/TwCyA ?6:LdD",2,2,4,2,skip
c#CDP[q5Jb1P`O8G:W.KXfm0M/9<hY\t!/p#>$,^W456I&yrVB V56Z/T\oam7i_s@zjV l+wqdTN_Z*&,2,2,4,2,skip
"c8^A4+e-mq)/""HK!+C5l<U`Ku)1-%gZVFuteUO",-Q|`r89/6S|!jjcc>*M_w!/B6IXKj]z#dSHB>t(=;n,1,2,1,-1,reset
"c;Z3a#dkp}Q%Lf0['fVBkF=g$'C""`zU[3-!aHV","NO+q:hGEW1t nU4\""""giTvCUS7o.&;\~3%\Cc!9J&.",4,3,5,2,skip
cH;Ozb/|5>N]^9Ca$'fx5'o7%|&9T#ZKpKx`=X,".mmMC;=cj7x{& ]5b^4t`.HLVx |qS%*D,[HuDflMP",3,3,5,2,skip
"cKfVBN<|MR tXM;R.H2Y8pM!#./7wg`M)UQ""qD","JV 6ypGNL""9%+(#B)k7V$c)3Kt$>c;fMasELd6h3(v",2,2,4,2,skip
"cOn;eAV:q'""12,P7Wn;>'Px8vg\BZL.pm[""bTt",xy%%+VteC^RNo;(j6%f_0]!GNefDu4NNqvM)Yu=tS.,4,4,7,3,skip
cfD^ a7@g8L?.tUy<Zn:{G|.`o'<%L)8eK!Lw2,"qD#e/PrlCS,]eq""prZ}Qx$8&J8wyFG:YcyH/CT3L\<",2,2,4,2,skip
"ch`*z]WQ@s~.I7%8T_?;8nsJz}{r;"".v[,Jq9T","hz3>~d""HmDw|(ZeH2/1^!v.o~\@HCx|+mq;vE!Cqf?",2,2,4,2,skip
ci~uuUMY&\!)&*la?8EXGQ(KcknM}1.rtdU3;9,"aO8N=@dV~Dwu\V4{8[$v,r\s5mprn4pUD^mz@r^rs>",4,3,5,2,skip
"d'CR+n;""27+9.IQ^yUn96\#*EpL>fs~YSzjLI ","4Qf9A&kJH=e9:fo`'qOo+'quR\965oU%""7}.,iJ4hv",3,3,5,2,skip
"d'CR+n;""27+9.IQ^yUn96\#*EpL>fs~YSzjLI ","4Qf9A&kJH=e9:fo`'qOo+'quR\965oU%""7}.,iJ4hv",4,5,7,2,skip
"d'CR+n;""27+9.IQ^yUn96\#*EpL>fs~YSzjLI ","4Qf9A&kJH=e9:fo`'qOo+'quR\965oU%""7}.,iJ4hv",7,9,11,2,skip
d+:nQ~IkS<<8.KgOk:Oz%rUV[nw{(psd#I4XS',"33+o7R>BLc8\64""g9E4/}a fox7PM8KT[ohKG3p ,V",2,2,4,2,skip
d5*DiT~i#(d;3^+yQv]P5[_ %\?AAnV7UYiKyg,h&G( 8*O~1JaB*dT/ZAs2:4S$EQ#z[D=<b-*c1lD*m,2,2,4,2,skip
"d6el\2/,qU=f3s~Mdrt;d=ZYEnK;bk{S{i*6,H","2f=@M/J^>3Re 0Zq-YKApiW3&M[""^z=NGupu!wFRC5",1,3,2,-1,reset
"d6el\2/,qU=f3s~Mdrt;d=ZYEnK;bk{S{i*6,H","2f=@M/J^>3Re 0Zq-YKApiW3&M[""^z=NGupu!wFRC5",2,2,4,2,skip
"d=d|!jOa)rW8fumAZ~+Gx}f*q]oC-at?ny+6""[","+N|m{AhdV1f3Sg'JK'=)1qVN(R~QD,q%j'mi1Fbgk]",4,4,6,2,skip
d@f2.S|{2GjG\eVf$Y*Iq TQDnWfABcC^FPy?v,\k^AcEFetLD>/l+].f>f$6/fX_5B?]Y3tr@931VL)Q,4,4,6,2,skip
"dXh/:T""F)?CUwZW#.^\Z#]TEu[pUOiny{]<'f7",7MZ1mi+fj}@v3MVDU{HhAa|uj~aVUP|Cun_6Zp!8;*,4,4,6,2,skip
"dXh/:T""F)?CUwZW#.^\Z#]TEu[pUOiny{]<'f7",7MZ1mi+fj}@v3MVDU{HhAa|uj~aVUP|Cun_6Zp!8;*,5,6,8,2,skip
"dXh/:T""F)?CUwZW#.^\Z#]TEu[pUOiny{]<'f7",7MZ1mi+fj}@v3MVDU{HhAa|uj~aVUP|Cun_6Zp!8;*,6,8,10,2,skip
"dXh/:T""F)?CUwZW#.^\Z#]TEu[pUOiny{]<'f7",7MZ1mi+fj}@v3MVDU{HhAa|uj~aVUP|Cun_6Zp!8;*,7,10,12,2,skip
d[|WQ\f>4|=U2eV4B@&'.Er?~]OgO\RO5Sv4I4,"Jqe$:Of+9!yQLkl%If-mtT}h_C4Fnvj^}JAM,Msea4",11,11,14,3,skip
"dc6,=:sw^tWJ'.o{`5kHtaT8:L%$zc-:ops4Wf","K/K&^dftqfy;RIdC_j`2P'/@e'j2RNi=%=2*D""7E85",2,2,5,3,skip
djzM+m6SH2qjS*UFLSV7d^Z>rjh<?rKhAxW*-%,Ras:V&HW\{Hx;XyKXMoyh*l[`2_)?'A63S(BzEF[ZG,2,2,4,2,skip
"dwU?:ko|LPd~{att<j),Ry4C%l:a*rRD1wo9G]","&3Yq/X:|ZgrvkYFL];s9v{v^(D!-""5C&m[![3s]4ge",3,3,5,2,skip
"dwU?:ko|LPd~{att<j),Ry4C%l:a*rRD1wo9G]","&3Yq/X:|ZgrvkYFL];s9v{v^(D!-""5C&m[![3s]4ge",4,5,4,-1,reset
"d{]@/(S^dSLqV*i2:NDmOr{""%>``w!Ch;y49iN",";Mc3v|@xhZ=zz>M:,`E/~""JrH$;MCS_;l)PZs(GaW&",2,2,4,2,skip
"d{]@/(S^dSLqV*i2:NDmOr{""%>``w!Ch;y49iN",";Mc3v|@xhZ=zz>M:,`E/~""JrH$;MCS_;l)PZs(GaW&",3,4,6,2,skip
"e(=8_5s""O.NKmTXcfyr_<cIU2#A0kLdeBOM{Q:","&MHN""7wCdefW4,fk^RG_qqWS-H_0B[s+<{AIXK{p:J",2,2,4,2,skip
e3=6$dL#b-o)_f+@G`v!I^/f:eaj}HDLJQ]OnJ,"fvxc+OJ)~I\$1(3a|i'wmJaz@Dw:U>87,""gH1r{""]p",3,2,4,2,skip
e<ZbK%w/m7i|v_CXgM;?^Xp'8_ ?E>\.|kntr7,"nVL=ARK)ED{x_ GT?j`zh,^%m.0w[( X5B.Z1Pc~3p",1,1,3,2,skip
"e=xK#&9k)+-Kci""8P<sWh?z/6x^E$yr`PXL0Fp",(d99grY%@=2=9hqL{fA8;KFD:Dk8u<(Km@j>Ld.(m^,1,1,3,2,skip
"e=xK#&9k)+-Kci""8P<sWh?z/6x^E$yr`PXL0Fp",(d99grY%@=2=9hqL{fA8;KFD:Dk8u<(Km@j>Ld.(m^,2,3,2,-1,reset
"eS!u^S""liZP'^PaINxu,<v.-.h|y>5I%F<>da*","VNU""!$?E*|:xk0{|oaK^WW.%HL.bkcd)k4'iVR^Acx",4,4,6,2,skip
"e\N}""2QEx(i;|eB$5TU!W#_Pk'C:424on5]T:^",wP $-N/#m`i}~yPLm8U(i sc.<>ZQI@CC(v\Lwo;O{,3,3,5,2,skip
ee<:D+G$|vr#\\7VFq\!0P>P?Ni.(A-./BZ3Uh,"NRuIDzn[HD/""1LG%teS'hP}TR7OZhC,,h]7P3w>Xp=",4,4,7,3,skip
"e{MbQKbx_*@?uLjW`<G?9>t/#\IL$})d,FU)WL","^-al;oJid[5e[ Q9(3,A>$ I]QS%""&pN!Zo+NLW0l&",4,4,6,2,skip
"e}k6o@wIXlw]1ux0a{Tq\6F*,wb=^JKEMR}4!#",Tr+/J-SP*N@NDCW5LpuH}5A&&i!0A5kX[PpX.<wM+`,2,2,4,2,skip
"f((UVW^ j&""G*r\MdCqc0*^3R?V'C5E!VFwP%g",)kTMVgwlCZG[Str@bh'oLh7'[?>pE%}v@DDgu/:DrK,1,2,4,2,skip
"f3_x,M!/mh1Z<AFq[j5 &,e}doe9,C,Y>6>hy`",)O!FO-c0ip@!(GqA-i8P3oLDz'^4M se<sRr`k/MRy,1,1,4,3,skip
"f54gSu!Ms&:E(%U02l[2)E$>Ev-l6rVuCy,I <","+9G{|5{L$8B9|uNTwT[6{<cPlR}=m8zT8j4*'#Z,dt",2,2,7,5,skip
"f8i),'Ip8Uc7h$_tPi#5drltC?h4F\Hhu~H\ U",EE~'U*|.]fYF`15wM>nf&FK(#N9h\c~2c#lr6Z59K2,2,2,4,2,skip
"f;YfF,{Z.-EE%HiF6{S(wfJO d8+FqRvyIIETl",qn0Uo[b{w=DX.<SHodYDxqj;.Gm\Kx)'OP&?g UU{<,2,3,5,2,skip
f=hhj`@<jvR9$58U<GABMf&;]giQ{p}mAcT;Jj,"4(""EQ'')bs5lo$>iF""s34<2.D%#oCA-d;'gUp,/$+r",3,3,5,2,skip
f=kGD_m2Z?09-%$6O4Hepw_gB]u&XcBElsIzDC,"n;.C2o.I7>!/gA)Kfi{nNz[`k9XpgJL/u[|\5LEkZ""",3,4,6,2,skip
"fFl;1e5%]='D_H4-I!.KK7gGYvFLL5,8-?WiH(","3X""5@(sn`>f0o[Sw[U""f/e%9@3&^))x]pUh2U.?X^>",4,7,9,2,skip
fOi<#GkGFr|W|[?n=9qSY-V`OQM$fWZjIpBFH-,\pi1\Kc6A(c7Kn<L3<s<~sh?Oo~Z~pM&o~Ou %R^h9,3,3,5,2,skip
fS7~:H]!^-1af>QSDP!EP4]UDazcK&'>(O> 6C,d+C-+V}{eeIgGPRRj{2pp7i&M9]96@(xa*&m/]vhYD,3,5,8,3,skip
"fTQGCj*Y?|lkR=u5('9cDm^pH|W|:b,""GvoC!Z","}?zVvo[S=s{mci+\]6bF_%#X1q@-8g)m${qY`DG""S\",3,2,1,-1,reset
"f\[V""ja|kc^v0QQ(/kkiv8};EG9J PB;fWdypm","H,u+Tr&A;r^@2*2vI]siG 6e>;F""-=nv?lO) vGS(c",2,2,4,2,skip
f`409Z>#K6F\)+.?<NTAp#uPt{X9vw`!: vxN4,"dt]*KKrsR%jMrN%b1rPgvs+ZgxJ3Ub.L|QJf',m<z-",2,2,4,2,skip
"fd}@G>%9F\5__:r$O@-);$`@t7,9'}=}<DZ6g3",z+%$V(R_[^OG)n1XO/jsy] B~nfyS +{HZYj!#sh$f,15,39,54,15,skip
frcn =_kj/%POaDMpUrY=J+-_hov]bOS**~>3o,jI>o]*3@nY1v'noC)0@s2zTqC/ZMpadoQ7Al<uVrtN,3,3,5,2,skip
g#Sg(Dwh:Q1G#e --Ek_5]$EWfy5PvqGQB$P>},"v0\_~aj.o""wc4;[Wa}D/VX2zUUJHlW0PAc$X#[`UJ[",3,3,8,5,skip
g#Sg(Dwh:Q1G#e --Ek_5]$EWfy5PvqGQB$P>},"v0\_~aj.o""wc4;[Wa}D/VX2zUUJHlW0PAc$X#[`UJ[",6,10,13,3,skip
g/szs6GGvQcTH-eCZZ0$rlkKU \64Q_AL'3%D@,"~[%?=69e,>a<3PynYhTr!1{&Mo41*3_8&nBEtA2v]>",3,3,5,2,skip
g34#!blhi-*4iD]}t4$[@6?`'uUJ@v.1EKt>?@,"f+L?+(XLFhXD,\Vn&vi^8JW.)ZVnXX]|?`+_I<jja?",1,3,5,2,skip
"g;35:drW0$U`(gAV:.5=@ki_pOTqj2~SVy(""9,",\;]</Zu:kEpn(uN913[tKw8_3ed6e*w<u0>bd<P^Tk,3,2,4,2,skip
"g<SO1x9Edi8.]I?<u=;%U)sW;:|P!ONu""40`]t",l#vX'ADz(u>eVa[AllGWC63Hh|/ER$V/)YT+0enDSZ,4,5,7,2,skip
gN%e-dh1#Nc1z  eKt4#aD{TC<N\4C9UHPO(o?,kq!Fi LB*UQy%#o0'UHuGxMB?`$l'8Zd*0U;M{95FW,10,9,11,2,skip
"g[01+ltbxZd_|9,JQMY<T/%*IV4b}lWnt&zGI'","?Ij]B^""]""&ePueuXNR`1""Zou""?k9g7]FLi*LBDxcx%",4,4,6,2,skip
"g[01+ltbxZd_|9,JQMY<T/%*IV4b}lWnt&zGI'","?Ij]B^""]""&ePueuXNR`1""Zou""?k9g7]FLi*LBDxcx%",5,6,8,2,skip
"geg3p1Oo{e~B2(xEN,q4XvV8j#\n8i*&""nBdY>","nOB9>7?8CH""G+nIl<>[@)r^87A;c_p!O.XaoU3 [z?",4,3,5,2,skip
"geg3p1Oo{e~B2(xEN,q4XvV8j#\n8i*&""nBdY>","nOB9>7?8CH""G+nIl<>[@)r^87A;c_p!O.XaoU3 [z?",8,8,10,2,skip
gk-'pJGF<Y.|.j'*T;2G4\0W)FtM;&Sw5Z6QPf,"6)+*(SYh5~%X:Py=Vp}kdM,a3T0/D#};C'o4cg(ZMm",1,1,3,2,skip
g~``!lJdy^-T}[J8|U:RSh?+@0Q`p_ygeV>VF),-%'j1/[#jxX1GI~_&)O?.?7F!VR*2EI##Z{jmv+GnS,3,2,4,2,skip
"h""C$JM`KmPD6F7hpp2&X/hb""g@_@D9Dg~_}qvu",U#Wq1n_wy$gA_%@;4L0 f J-L}aRZ)a]<Q\?%G]~3y,3,3,7,4,skip
h4Q2a!/BOL]vT2k30gys*8{a~`wDJ{;7fAqm5),"dX1`1wiSi*(d{oC8ov7a{w|2XLha""#Ryhd)oI&S.%c",5,5,7,2,skip
"h7Hx~v%>QI>}IBlWEk^Domi<BA=Tq""~B\XA pW",y ]he:o4=Y*Q&ScSpj?)wDel).^9Q!5WhTY@JM7N\f,5,5,9,4,skip
"hAZofxlUIO""%vLV:ld{PGF|c~:5q<g[C\582j%",%n{.n%X3% MOub(<h\omwk%V7ekQ)OZpP|$>q:o^$V,1,2,5,3,skip
"hDw[`?LPvY+GdO+u~m|;dAgYy;V(,<{m+_en4}","`)dHt':[|jWeV496Sot`wur*O{)XeBm|.BEKN,1_;Z",4,4,6,2,skip
"hDw[`?LPvY+GdO+u~m|;dAgYy;V(,<{m+_en4}","`)dHt':[|jWeV496Sot`wur*O{)XeBm|.BEKN,1_;Z",6,7,9,2,skip
"hHG33Nq:Td!FaQ=$bXGk;v`Hw+c>""\ 4*P?0HN",-nLc>>W1\0|0M!#DFq@e^a.f4qkeT|dsjNKm:|g<ll,3,2,4,2,skip
"hI_[u(""4{,Fc\87a7I.-+>ckOKF]h5~vyWpfU-","#fAAgi}!,!KLe~@gdIyI,:5d5lC-umXBB|l%\TKoGV",2,2,4,2,skip
"hI_[u(""4{,Fc\87a7I.-+>ckOKF]h5~vyWpfU-","#fAAgi}!,!KLe~@gdIyI,:5d5lC-umXBB|l%\TKoGV",3,4,6,2,skip
"hZ4@9!W?r33%92;2gq}Gy8[E6W,}ysQ)*}VU?0","A<=GoX`FX}R!VMOHhya&Y]IZ$hx*bSL-}18g,jo'4I",1,3,6,3,skip
"hjeX, o]oe=_ckv8tp|5F^5B`;n=O<10~.!3WA","@6 1/xN/oo5&rudWwJ:DPh.w4`+L%uyMTt,|!6q'}J",3,3,5,2,skip
hn<_47<-zj4Z{OU]5='%1?yB>|t.3Z8^~{PuSC,"Penfy=&mwh;c""j@YYLIQdRGUA]+AB5qq`HT/!CG~*~",5,5,8,3,skip
"ho(?<l 'wWQ1x(O aFg<EyOO^""`eSPo,9lcG2+","$OFu>lz`._WsISS<Cj1/?""fI_`Hhw4oAnhq|*PZL]A",11,11,13,2,skip
"hq+$xy^BZWIUf\*o;qW{1C[|W""%[.g`?^u69G?","Jx>Q5|@'X:sDC""'MoEz(;5}z$H""SDeK'&4Y{Y>#E,E",1,2,1,-1,reset
"hq+$xy^BZWIUf\*o;qW{1C[|W""%[.g`?^u69G?","Jx>Q5|@'X:sDC""'MoEz(;5}z$H""SDeK'&4Y{Y>#E,E",2,1,3,2,skip
"h|J5~?$FG=O-=`-""swoV~Q!B71,V0y{`j^2+<<",e{eu&S87v!uVq^wH(tc[fuG3h |oI+reVoxO~??5OQ,2,2,4,2,skip
"h|J5~?$FG=O-=`-""swoV~Q!B71,V0y{`j^2+<<",e{eu&S87v!uVq^wH(tc[fuG3h |oI+reVoxO~??5OQ,168,159,167,8,skip
h}_W+0gV~h\)'jPv8&R&v6qz.p3X{;WQ|xHE5~,2nDO9h3ln;cx3J~'6G-S/a2S$i+$L!mP_W}F+tyI=j,2,2,4,2,skip
"i+aQN;5Cz,EUDG %7R]%986yZ+D~7^e+f:bjoU","(~;.}+kTNN(~w=>wlrE`cnZ{.G?G%MKG,B]RQ4b$M)",3,4,6,2,skip
"i6pS[+}*""&t4K/IGep?Li[P`=(tF]_M!CK%8WN","}a4,{\0s/Jm0cs9$#)]Ha;((f!I$%iBalW\KOqS'++",2,2,4,2,skip
"iD+o8Uq=3fd%k""btv6to;qf:+:Nhzj,_J2|5Nb","6%I5+-kB\*rlwKQvFN""&PnNxE[DsX[{L`OlNKhDaZ)",4,3,6,3,skip
"iE!AH~LPbeham?xHZ6""wW""8eFjb""hM'%BPoid,"," W9[3v""8%EK`3)""caok|_jQZ~ScOX!5mzs&iY*%B3I",1,1,3,2,skip
"iE!AH~LPbeham?xHZ6""wW""8eFjb""hM'%BPoid,","sf5Ko$3<i@IF%Gi#jP3+9g`dTw4'Zf`,sBHtNiv@s0",2,9,11,2,skip
iT\4< #rO[O>qppI Tj'&U~g2AR$u803yc\m*M,"i8?^AD+*3F$""Yai^ed1+m#KkB""l!L!Xo-^.EmG?;V}",1,8,16,8,skip
i`c-s[UU(Q]GeC?J>+Bakh[%jdfQHOZ{Q`_Z|G,"!>$N9b-#8sz)z)u~ZoLkT[K(bSD=,Ez@na#y`C+x@}",4,4,6,2,skip
iczMcP~6OlK[AD(4}o'yXMoCH!lY\6Sy2mBegH,/OQT-vA9GIsxi~J)>A]eDJ|Jfe@|cqO&~^{Wv1OTV9,2,2,5,3,skip
"irAJAB^2g|$k""7Vp5U7 |AbHfyt|Gu.+VQ)vhk","p+94Aa.E{2<aX&tRIN8;6mb[!,#9L/`VUQ{Ar1fX/W",2,2,4,2,skip
j vhD(d?N]<In9S\O~FG;adrw1IEjm`{[5ys!X,"i'IUu5ph$O~uG|73-eB$0gRI J,w`,P*G*k6u@%jP.",3,4,6,2,skip
"j""4;'I;u_ww(kbqsTB1T[HN35v+Y9alQUr#CB0","Ae522LcnUyfr';<D7{3UwLfW*2]c#}`]-mCq?Kk-"")",4,4,6,2,skip
"j'A1i_2n\:2h^>&z}fs$1u/a{o@3Qi0t,= <x0","#YrLNuZ""isjLPgZ*p(%IgrXzFMh.PKksX5)_6ai!8m",3,3,6,3,skip
j5@6ozav*]uAdow}ppo{kp~'KYFy2-u8K7s]k0,"7iv6yK'LhwEW:`_X&l*pf.nJ9o!V%NLsok:u35),mz",2,2,7,5,skip
j6%5O^e7qy'wR6(mTr9Fz\'fC[~M66nj])hhP4,7rjAiDGHB4J:Ws^FO/^}IyxQl6sHtaK!cm`RSM=Q@k,1,1,3,2,skip
j8Yp\:{VLM=Y9Q;]d-YDj^[LM2eRv*HYwh.iYx,"=s$O~EU&"">cL_<3n(mc|AsYEb`gd?R>1$}qq(ClG`D",1,2,1,-1,reset
jD.2R' !)P_;3QQf;b;~cjii5YUa!![Wn+6lt!,FNJ|AY;>eSrbq`iy#nzd{?9N{Krw_]MBT|'57(:x'),1,2,1,-1,reset
"jRg<MV,mTIh*|$V/7WyUZ(6mCvW59b&iY4q[Pv","#X#:6{o@ZW8\aL)Sj9$Kh^w},}IC%:*AG8+YehY#R3",2,2,4,2,skip
jY!<809ha^]F-4ok_=/?>@A{MDZ4^.\~nAodmt,}FiDg!_&1%^9q!$9#TFS#e^1l!P\Y~>+uK$P6\#H;G,13,13,15,2,skip
jY!<809ha^]F-4ok_=/?>@A{MDZ4^.\~nAodmt,}FiDg!_&1%^9q!$9#TFS#e^1l!P\Y~>+uK$P6\#H;G,14,15,14,-1,reset
jY!<809ha^]F-4ok_=/?>@A{MDZ4^.\~nAodmt,}FiDg!_&1%^9q!$9#TFS#e^1l!P\Y~>+uK$P6\#H;G,15,14,16,2,skip
jaEjCMz82ZC|I}&o]QPu0@q}ur`IiyHsh!8b:],"So-<?M$O?:*@u/l`""cCe;vkV@jDs&fVb1>iDwOPX*o",3,5,8,3,skip
jz`7 J~5e)*ga?Y=|x?GxIJ>^=YT_y!`y]wR6z,"P@MJGZCo8cBy2m{A7|,@3RqIS==0Sx#Hv/V/wD=[2j",2,2,4,2,skip
"k%/zKdxY_|?<G(Fr]mV/k/5 vv""M#(pK$""7@iH","{xoZ|u@.wkKMLI]ya@(>r$~Yc""pzA4n*k8pCmY NXy",2,6,8,2,skip
k%Y9|%-u[>#@P(hT~^7.rtq0]6[2J{Vf?Pl|*W,'y=2FH`i<(e<]DsdS(r57]*aV?[a P{Ij-bt[s'e#3,2,3,5,2,skip
"k7@ch~;""w-jrwUb[`!wGI0G0Y11]3<P)3?<eNs","4'NLpNZ[%4.3H7P*Jb3x)mWj9(]RL&2(f|G~Of,d;,",2,2,4,2,skip
kV4::#kW$`z+0PC`-o>-tC~g&J./X<$!~U%#3K,"HeVZ1Vh<I""Cz3D!B'25+<^FAQHduU%4G""ykqxO{'<b",1,1,3,2,skip
kV_O:2\Q;f2*Y]ckZ' 0]/L3k!w)CqLm|mtlaT,">*_8bkQ6;vI -f\o""+pg<l4fo:);(5K;<#fx3IxulQ",4,3,5,2,skip
kV_O:2\Q;f2*Y]ckZ' 0]/L3k!w)CqLm|mtlaT,">*_8bkQ6;vI -f\o""+pg<l4fo:);(5K;<#fx3IxulQ",6,5,7,2,skip
k_UX[-U5dZJ A N.o3U1'r7 M?S#P%uSm^FQ30,"?Sv~[8.8~G>Y:<D/8! xL#D6R;w z-eiSjvh""#AG2r",2,2,4,2,skip
kzkkB*'eAu`~0]1!.)kuYSIh<'k*JexA6m#/3p,I87 u7|1`KLQz#Q>f ]B+.Hg=hF0iq#UvXA'VCX2yz,3,2,4,2,skip
"k|u%xPPe`@\7 99[E.""qsfB]$E~Oq5%!l7AEZ{","cpaAZ#],htn0!]ebdK&QCs1K~&(DEq>N@6';Qe@}37",4,6,8,2,skip
"k|u%xPPe`@\7 99[E.""qsfB]$E~Oq5%!l7AEZ{","cpaAZ#],htn0!]ebdK&QCs1K~&(DEq>N@6';Qe@}37",6,9,11,2,skip
"l""R6 Y82O3T)5:=^| Fn<X}^i@)vy/`u:{x?.o","Xr#$2h$,##QeU?q0Q3IMw?.nW.Me8o.X6W/6=NvxWP",3,2,4,2,skip
l*!s }HUgQaz$:^qZl3@t&`\-jN3u@/lmlDAEs,at/1{Ko#2o2p)9@xz=')gx9]#>'.AxpBb^v765S'oy,2,2,6,4,skip
l+%1\W9;Zb7XtfH:}j0/c_cj2J2#`V<3T[\mcV,"HmrU-6""|LLBqP)fDbS[;C4b?-g4&|j[].[-MTDm!m ",3,2,4,2,skip
"l/2 8XUsLjc`+{G*uYl_'-F)vOX1:O6,(-f)F^","7q0HGFeVUqI7=7uK+;IWMCM""HQ F+cvOSOv+HSsY+]",6,6,8,2,skip
"l/2 8XUsLjc`+{G*uYl_'-F)vOX1:O6,(-f)F^","7q0HGFeVUqI7=7uK+;IWMCM""HQ F+cvOSOv+HSsY+]",7,8,10,2,skip
"l/2 8XUsLjc`+{G*uYl_'-F)vOX1:O6,(-f)F^","7q0HGFeVUqI7=7uK+;IWMCM""HQ F+cvOSOv+HSsY+]",8,10,12,2,skip
"l/2 8XUsLjc`+{G*uYl_'-F)vOX1:O6,(-f)F^","7q0HGFeVUqI7=7uK+;IWMCM""HQ F+cvOSOv+HSsY+]",9,12,15,3,skip
"l<Ci<ZC}DTn+<-E<dE""(_;DL#iVPTgl/fLfA_W",x$B_T$~<RR95aBjZR)-#.6S_\[.~ JG`8g_Q1c11o!,2,2,4,2,skip
lT5uY8'u='Y%'n4BeUwPZ%HzYp7_O2\*_0Eti7,"0sCT,#18eA- C""A)J'oKNK @j38 ,#v&KnCALU2""`)",4,4,6,2,skip
"lYJ~e""Q04qK]&!:wdKjJN}]_-{'>8#!7mCs{bS",|I}]wcOix0rlN-)Zd5'gc$v!Y a#]=fnE;?CU1fvwi,1,3,5,2,skip
"lZH&f\=7c[q4e`\vIG$D9Lw!shn#R8o,E-LXwo","+uro{JSNs)\V4|tp,9a?pc|~Nu8}0p H??~_r[Qzar",7,7,9,2,skip
"lZH&f\=7c[q4e`\vIG$D9Lw!shn#R8o,E-LXwo","+uro{JSNs)\V4|tp,9a?pc|~Nu8}0p H??~_r[Qzar",8,9,8,-1,reset
"lZH&f\=7c[q4e`\vIG$D9Lw!shn#R8o,E-LXwo","+uro{JSNs)\V4|tp,9a?pc|~Nu8}0p H??~_r[Qzar",9,8,10,2,skip
"l[;2Sh\3[-!,^4c'\dw]L~p_GTX\c4CG4/Zsi[","ec0icTK6TllqX%y+jte#fE<Ce\Et-&@M!VHI=[ ,H\",20,20,23,3,skip
l]\4?uMg{:T3`eIlh6FX(Xm=8rBp}B<e~X5|Ga,Q-3 [wR/sih8G!M9&tU:TvI=TXDYKiL-W7We<E%JE#,2,2,4,2,skip
"lc+%H:8:iVVWRGJ8K`VrZ>GtY:A\`.""LeyzQ^F",u)b>`%0.'d]%&1( g7m4t3PG6HGzdP==33hh&sflon,2,2,4,2,skip
"lyhR D*``$w\TMK;;Zm`80\""*;hcuzm-gzh3D/",JObMz_P%/+J^%^fO)Z4OD+Sj1%Z+4)FBR-D.n3JNmw,2,2,4,2,skip
"m(Bepq`$3PFs\3Hv&>s,W>K.A|88EGA))oKp"".",LJoP00//w_Hg)Fw*]\ihs<Is3<j#lvaXVo~T_{T8?a,4,4,6,2,skip
"m9-o}FB:9%O=^ZwW61>B3+%""*%&hfCiA!^2v[@","e4Aq%xb""BO""moTzIN M1xG0wpSenX+V5YRMG`p~g8)",4,4,6,2,skip
"m9-o}FB:9%O=^ZwW61>B3+%""*%&hfCiA!^2v[@","e4Aq%xb""BO""moTzIN M1xG0wpSenX+V5YRMG`p~g8)",6,7,9,2,skip
mAPH\Tj*}[=l*D%HF B%cDVxPK'Ed?<v.+H++w,"$n{VDaIF\](OuA<|!MIj=y,)AbDzqY >5p|g5+ZEYX",2,2,4,2,skip
mC;H!>+N]xlm3g1B^{=du!!!>B7etRFzF(5N5=,"SD`CYj}-8G2B5'yi.,Iw7$""Q$zcYCKw5CsH$h0oI{e",16,16,18,2,skip
mC;H!>+N]xlm3g1B^{=du!!!>B7etRFzF(5N5=,"SD`CYj}-8G2B5'yi.,Iw7$""Q$zcYCKw5CsH$h0oI{e",17,18,17,-1,reset
mC;H!>+N]xlm3g1B^{=du!!!>B7etRFzF(5N5=,"SD`CYj}-8G2B5'yi.,Iw7$""Q$zcYCKw5CsH$h0oI{e",18,17,19,2,skip
mG|Y?y+3ygyaL?iiKJo~y+DfB{Rr=2tA*2D@6X,"33OEn}Rg#,)[<g'[A]7N:&Qp5^q$Bzg77q`[v]hfSX",3,4,6,2,skip
m[ {[Cz#Ku{#m;2Y_fW!g_'5;k!-k58}y$eB3h,"6: }A}vVR%&lGo,5qZXvUGF7GTz{$t4c{ b{$t^JDi",2,2,5,3,skip
"m^qy59P)dYJd4'""qRC]!v%/W }!^O$:=$fhZ-Y","=y7hK`r>rl|ac#@P_*>""::md;G/%FXuMD_b..,eHZ?",3,3,5,2,skip
"mplLRY""M(%~VS_^Ar$W,s\u<Pu.MAI`e6Gz858","hYc<PEq""y0Hp7]_=|vpto$S7LAMJ kbbgNqhfuosID",7,7,9,2,skip
"mplLRY""M(%~VS_^Ar$W,s\u<Pu.MAI`e6Gz858","hYc<PEq""y0Hp7]_=|vpto$S7LAMJ kbbgNqhfuosID",9,10,12,2,skip
mr\8nUuG3cD|}<'+pH@x9;/_w~Y!+Na|wbworn,"%&O0KI!fm8*@j5Q1Cm@BWxx| 4Tcb*D""2,u`zBu,o(",2,2,4,2,skip
"n""5kQ!&/M<_/P0%k'AX*)WMYPI$$9,f^,`6R8>","FMl+0S~gZ172,9X2Ld98!jGucrYt~m|q*}7iUl0|))",2,2,4,2,skip
"n*,sWJ0lZd6K0Vu3J~ WgdPP+GT5dET-4#(CWt","pfD}WTP]=^""&5B!kiUpvr&pCF,a5C- GQm]trF#r>j",5,5,7,2,skip
"n*,sWJ0lZd6K0Vu3J~ WgdPP+GT5dET-4#(CWt","pfD}WTP]=^""&5B!kiUpvr&pCF,a5C- GQm]trF#r>j",9,10,12,2,skip
"n*,sWJ0lZd6K0Vu3J~ WgdPP+GT5dET-4#(CWt","pfD}WTP]=^""&5B!kiUpvr&pCF,a5C- GQm]trF#r>j",15,14,16,2,skip
"n*,sWJ0lZd6K0Vu3J~ WgdPP+GT5dET-4#(CWt","pfD}WTP]=^""&5B!kiUpvr&pCF,a5C- GQm]trF#r>j",21,18,20,2,skip
"n*,sWJ0lZd6K0Vu3J~ WgdPP+GT5dET-4#(CWt","pfD}WTP]=^""&5B!kiUpvr&pCF,a5C- GQm]trF#r>j",23,20,22,2,skip
nCSjC<Qv7 e:O/=d'=CC64Qa/f5@}_y~t6?B&n,"x8qGGUg%sS+"".Xj]\Eo%M5I8ZF9ELQg5T[M""s7z=N""",1,1,3,2,skip
nE]E]a2-S7h:eZ-H{$C7Q*rC2C])t\7e.3'>Z{,"W;qc/Y%d9dVKC|)6YeVW{+^`]H""q{3yZ0t9&mOY\>A",2,2,4,2,skip
"nT/4BM&3)+8J)L'D.aC,m&gT(QhMR4F;~w=}N'","wLfHr}b'C;r1$yGKk/f[kF,tDLLKevOvE\{=I`B7=7",2,2,5,3,skip
"nT/4BM&3)+8J)L'D.aC,m&gT(QhMR4F;~w=}N'","wLfHr}b'C;r1$yGKk/f[kF,tDLLKevOvE\{=I`B7=7",5,7,10,3,skip
nYu-5>{%N>H103{<K<RYuoREI3zMLIM}}v&TfD,VKsLy]8viIbWV@r{f?C.pS|k-P'_aJcVM>/n91=iWh,1,1,4,3,skip
"nodxr3bTjJ@}""y9JIYM9,X3ZL_M3Z55n t`5x.",3 bg}6B7.:={bZ[Nqi~*$&R$\i@{py]]sy]lt0pN#;,5,5,8,3,skip
"nz(Ip9sZ%c'%OU~Ddi14;i{Nt`i""KBbfnj3u*B","ejkt:\63;}U;IzCW,k ld~h<lHsMKN{lo_Yu;?yXX{",10,10,12,2,skip
"nz(Ip9sZ%c'%OU~Ddi14;i{Nt`i""KBbfnj3u*B","ejkt:\63;}U;IzCW,k ld~h<lHsMKN{lo_Yu;?yXX{",12,13,11,-2,reset
"nz(Ip9sZ%c'%OU~Ddi14;i{Nt`i""KBbfnj3u*B","ejkt:\63;}U;IzCW,k ld~h<lHsMKN{lo_Yu;?yXX{",13,11,14,3,skip
o#).&<dhF5uZ0[yamZ|sE /;p&A5kZ b~S^2|q,"&ya2<3[7qU6<dToPiX9P:kjD4BP6B3 +""AS,]KKHAK",6,6,9,3,skip
"o%Tc61XVH9\.eIj8I;N""BU-^F0qFb}g%/uA.L:","x(F,gwa(Db<;Sr7-,%H#1*:=]m""ZmYU8Ac|_xV,.z&",3,3,5,2,skip
"o&m*fNMNnm7fZ=x<rs\,`rPOCp Xh<5y{]-]UG",*d\p6_F\ q!u$P6xf{}TRga>x75<zDUTdA}@%m-'V[,1,1,3,2,skip
o4>rQ\}B Ukz7Yy)O]_\Xd}v+;P+EB^q$dwfR=,Oo[K89QPaSTc{P9vEFE}pl8f.:<$D$=<p9aNfux8oW,1,2,4,2,skip
o6UAM*uhaeAp;he&W?}Utg#/jWkxzT;K2.W@e5,"c\4?c3m__w3c7@n=GXmRw,.V1tzlN{43e\,3&,)4!S",1,1,3,2,skip
o6UAM*uhaeAp;he&W?}Utg#/jWkxzT;K2.W@e5,"c\4?c3m__w3c7@n=GXmRw,.V1tzlN{43e\,3&,)4!S",5,6,8,2,skip
o6UAM*uhaeAp;he&W?}Utg#/jWkxzT;K2.W@e5,"c\4?c3m__w3c7@n=GXmRw,.V1tzlN{43e\,3&,)4!S",6,8,10,2,skip
o6UAM*uhaeAp;he&W?}Utg#/jWkxzT;K2.W@e5,"c\4?c3m__w3c7@n=GXmRw,.V1tzlN{43e\,3&,)4!S",16,15,17,2,skip
o9{jzs1ve/[q$6\@yNK&1g>0hS&dtF3%T{ve1g,<Ey24XHmw~VG<T6EB<PV)6Sv948>H |DoQc{&=@9`D,2,2,4,2,skip
o>j(R90e>}'6Xo]H=&7}]zK YtYwIb6?#mShHW,BQ GdR0V:3nB'Q>e&^@*+/{XscYf<b!>Co&i8&[9NA,4,4,6,2,skip
o>j(R90e>}'6Xo]H=&7}]zK YtYwIb6?#mShHW,BQ GdR0V:3nB'Q>e&^@*+/{XscYf<b!>Co&i8&[9NA,5,6,9,3,skip
oH`n+V(|7?kH~PAcl]Yx}{~I-J3V n<C;2A)iM,"q$dg}e,}<Y%W\5C>/K6; @Vw_=~>6p9BCJH<Yi<('l",3,2,4,2,skip
"oKr%t"" 9/268:o2*0*t_9vPPa0#\VT//#W%zob",&7f$BL:c-x$Ft|.wgb8|3>F>B>T]z3G>[q&z<+:W-m,4,2,4,2,skip
ooa9F?q+B/<!~)jmY)3D;`K%(]jo2;G!BU589#,"FIxkp)V-V""io(:Wa6]#RtIl{KBd\E:5ys&dmJQu*|R",3,2,4,2,skip
"oq19lP|d_$;hUjL7PmffQO*zp{A{]~6i=""Yi5s",H~zsMT8]o&zZQy`l_(t?V3UT-;{1&Qg|W1o=(*.UBF,1,1,3,2,skip
"or3R!{j[Q>wbv,a3TB,Wp'\RvtW1?As4n(UK}e",3=^u^Yh2cYW<pV/[;`Yo}R4 $%N I1)4VfV&<JLwrg,1,1,3,2,skip
"or3R!{j[Q>wbv,a3TB,Wp'\RvtW1?As4n(UK}e",3=^u^Yh2cYW<pV/[;`Yo}R4 $%N I1)4VfV&<JLwrg,2,3,2,-1,reset
"or3R!{j[Q>wbv,a3TB,Wp'\RvtW1?As4n(UK}e",3=^u^Yh2cYW<pV/[;`Yo}R4 $%N I1)4VfV&<JLwrg,3,2,4,2,skip
"ou7(2$kIvQ^""`#DSwW+^,VX=Sa&KwP|niU!>#F",S&Nqh?zy$Fc~do:G4e]n-CCJq3DkgW(D?KdBl%{l}y,4,4,6,2,skip
"p'@j$;oGDw,2ipN|FvPRJscxR]9Zr%;-f]J1_f","7.x(SoB$N}+N[4u?;TcY]R@O`D,I)j{.El}Qa$c$o4",1,3,6,3,skip
p1V$ZQ&- l[mP+S{2eg2sM+)]Zmfy&GKg)WTyH,"_x^ukY""`A)DqZk[D'R/A}jgD'J/VdR0N#(FuJ<O_^t",2,2,4,2,skip
p1V$ZQ&- l[mP+S{2eg2sM+)]Zmfy&GKg)WTyH,"_x^ukY""`A)DqZk[D'R/A}jgD'J/VdR0N#(FuJ<O_^t",5,6,8,2,skip
p1V$ZQ&- l[mP+S{2eg2sM+)]Zmfy&GKg)WTyH,"_x^ukY""`A)DqZk[D'R/A}jgD'J/VdR0N#(FuJ<O_^t",7,9,11,2,skip
"p60@)^JqP<SCDn'-?huT%u1Gmv""|keOC.\fs#v","X""E$L2P~Zt>r.HNKzwC*Q;:&0HwCgETtxjl9kL?zaP",2,2,4,2,skip
"p60@)^JqP<SCDn'-?huT%u1Gmv""|keOC.\fs#v","X""E$L2P~Zt>r.HNKzwC*Q;:&0HwCgETtxjl9kL?zaP",3,4,8,4,skip
"p60@)^JqP<SCDn'-?huT%u1Gmv""|keOC.\fs#v","X""E$L2P~Zt>r.HNKzwC*Q;:&0HwCgETtxjl9kL?zaP",4,8,10,2,skip
p>n^U+HSgOo0!+>#]IlQBfK_{&zh^{23w].)4K,Iw%p28=uyZ<+m}z.{6_46xhJE'hD;mco0r4u'X.z4],3,3,5,2,skip
p@*|eR9@FBQ h7*@=d{U9BrFKS%aEz~d#jVqb-,"5OJll+f1i{-KpIUMmu-GbQ!@>.X""!_luYKL^ML=VNL",1,6,8,2,skip
pCLOv<}0M&\b@92TPWv?D7D3E3=f1[b&wSiP/m,>{zB0a0dk<x|RDCbAY~l7uhWxE`<:C_$QmVm?[HMY&,12,12,15,3,skip
"pb-Y~< P""SHgJ,1^9Dp'0`BtD=w+6r;1Q?|%-2","./ItuYoCPRnDyWf<EMOylYft,~wA,IItv*K.&@xzv<",2,2,4,2,skip
"pb-Y~< P""SHgJ,1^9Dp'0`BtD=w+6r;1Q?|%-2","./ItuYoCPRnDyWf<EMOylYft,~wA,IItv*K.&@xzv<",4,5,7,2,skip
pkqIVY+?O=<@V3r>sz|#{:6wyipTH$S:pG4YI(,-2E2mV|y/|lhc|4n1_R+G_u#0%+4>:0R^_b`akM)2a,1,11,13,2,skip
"pp~'=A<s0BZA&)^8'xS^y_Z-j^_!8,1wYI~R;i",S#_<~bI6-rI_FkVO;$irH(]*~r{G4>%lrM^&vi^Q~m,1,1,3,2,skip
"pxY*88K)v%(gk.[{b:'%xcf^},dugK}Iv2$<Vm",-B?S 7xg$|l|eMv{}(UiB8O?v3!~g8}hSa]xH$l)V-,2,2,4,2,skip
"q&^$(yr?@eM<)hptv:7""4^r+3YoRR-`Ej>>=VR","UO,FtGO`$|'[$z199 ~2b~XsfbxFjkX8S)UNxhKIl'",2,2,4,2,skip
q3J]Z.eDAU[d%@@xDy[iG}KqA<;J<IBycM.{-q,"nO6Eys!=<7F2?)%Ws:,-c{SDaG!o.4!Qd)<A!wIyyn",2,2,4,2,skip
"q3cg+M%i4,5Qw<$)>}7kK$:OrWx0?81z}5}SJl",BMNFOR*l^MX5}$%mJ2sXcyub?F0aNFT<AmZPyCc:ei,2,2,4,2,skip
"q>B.%v~QiDe4t4'1JzstpY1a5v""@LJ7o Q?""8Z",oqN\hk0SHUQP$iU|oam$h.rN[(#GHi^#a{%BZA*)d&,7,7,9,2,skip
"q>B.%v~QiDe4t4'1JzstpY1a5v""@LJ7o Q?""8Z",oqN\hk0SHUQP$iU|oam$h.rN[(#GHi^#a{%BZA*)d&,8,9,11,2,skip
"q>B.%v~QiDe4t4'1JzstpY1a5v""@LJ7o Q?""8Z",oqN\hk0SHUQP$iU|oam$h.rN[(#GHi^#a{%BZA*)d&,9,11,13,2,skip
"q>B.%v~QiDe4t4'1JzstpY1a5v""@LJ7o Q?""8Z",oqN\hk0SHUQP$iU|oam$h.rN[(#GHi^#a{%BZA*)d&,10,13,15,2,skip
"q>B.%v~QiDe4t4'1JzstpY1a5v""@LJ7o Q?""8Z",oqN\hk0SHUQP$iU|oam$h.rN[(#GHi^#a{%BZA*)d&,11,15,17,2,skip
"qAj/gqQA3W,Te. p+s=VmH@rV~Z\]_w|0nfa9y","!}edz%wYLW_fITx}%ySf_E+-68c?)#w{Y,/:7?n e3",4,4,8,4,skip
"qHJ/sR$7Wh;8_myh*]*L:|H`A5[|fB_(~tq""/i",4Yz=^Pb8'A4B$iLBuS%@[5rFXbJ[Jf6}8|e~VI#?)2,1,1,3,2,skip
qN#IT? 9d-0~sB]GVK^N/*{Z<XSF`:Bw]H#N5X,\JBF5AX<4WT@*t:\NHw^zrZM%F!JIo(<WW>Tsm4GgA,3,3,5,2,skip
qvY[/9s;aJwt!3^b_;\SC+Z1X<#CxLGd6q0/L\,"Vr6n>E/BD_r`_y#r,X_gV_P:6fwTi55s':jj[>op.\",1,2,4,2,skip
"r$K$W9J#D}m71+KACU,YS)l(!<heaO1?ZN{k73","B^""jf7^:TT1DI_7R[Ft!P?R K3gL@YZ-U.,fjj\>o)",4,4,6,2,skip
r/Isu;kUwCza/K2'WHrDA}FfLX_$CeJd*XVzWB,"y2$71NShW/l{XRY3|Rf{9,S(t=?Cxg2)-""EEvVJeE7",3,3,6,3,skip
r6g0<z51[QF()4@$u`=j+~CT_Cy=fgE8@hv/8n,"ZfCrT_(vR#lQT""al4;F*D?)EsBP45.^p>LBGK4!a9v",5,5,7,2,skip
"r7!]\MyB&(;J.;,C:wvx4?32Md.9<Uftj_na>9",Ie:$n8!KDDcR5hVw\OIjdz/dS4T`J4Hf_(pl8|@++2,4,4,6,2,skip
r;c_(n/ovh/bHzhji&w5SQ5K}6W/ORwImq0(N@,U~'DKub[+~41|g[zvz#GBte]wt9|6-MXi>jlz!loV],2,2,4,2,skip
"rFH- IDP\Y~LXnh?c)`:X;;~7""HSFJN]0dt6qw","3{qwxep)91Pd *wJu;Tn>KH(%Iawxy29VhOf]#Z-J,",2,2,6,4,skip
rIJz!~+FmNK1q%6tS5 {us :v(I/YdgUvUro)m,bfp3/n3./bXq?_9*3O.3ui+vA{@cc)V0`3GY$T^YJQ,3,2,4,2,skip
rIJz!~+FmNK1q%6tS5 {us :v(I/YdgUvUro)m,bfp3/n3./bXq?_9*3O.3ui+vA{@cc)V0`3GY$T^YJQ,6,6,8,2,skip
"rf[U,kRHuXs~Mv=kYtmRfM{$p4 gR:de`7]a,$","XOI-3o| e,FRg:1{D>U<-G/-b`sdQ2e*\]`Ze\?M_R",3,3,5,2,skip
"rf[U,kRHuXs~Mv=kYtmRfM{$p4 gR:de`7]a,$","XOI-3o| e,FRg:1{D>U<-G/-b`sdQ2e*\]`Ze\?M_R",4,5,9,4,skip
"s,[@C;PWM\Zt*h?>d+fF].yM'n|at-<^R@DZUe","""RzP!W(yoign40_yA`fx]([q/5KR`]nMNj#anqD49M",3,5,7,2,skip
sP=gzeZ03yriR+SL4#}2wkCx]W=$3[d56?XcB\,E@w)OB$CN.dhF+{UHBj)u&;NKvu{iQ<[vL0*M]wsP!,4,4,11,7,skip
ssrZ0~YB`#prnuWT~LF$6z(G7#K&R3(< kd]uK, ;3#9fRVaO;MPFyZ/J[rXk`q-LzCQN{]@Huu<eXi/h,2,2,4,2,skip
svcXq!><F&')N_hmgZ-L.7H1E64zoV-GI+1M7`,"!{]pK3+|^6W'hb""e%DEODyxpgB ~6}9k%>n1:=YLzp",3,3,5,2,skip
sym(GIv+COVS`YFg5)kA/S:;h{ywBorMI.->p{,"ylS$U8OwUN*Na-vuu=hO-:NC~{~HcK_2Ud""e5g9LuV",13,13,15,2,skip
"s}n)8)OHbj~L2[S<_nF[.*c =Nq$^56{AjZm""N","^YkWI6/WKNO0Rc@v.1\I^L,;o<YZjx%x^mK^"",0aN(",5,5,7,2,skip
"t'eh`V|{0=iL+,~1I6Sgjb-, ( yLBj(TK#(Dn","f*LA9-M.<P?RPpJulCk:a;FBs4&)e-D2nsIzuq'""sb",4,2,4,2,skip
t(Jw5BcY{fbpHp?XL64A~2]&/Bm=PQ!fC'|a{u,"oh(323YEZNLE,L'iaAS5.HffM0XrJZV/ P??RcKHk?",2,2,4,2,skip
"t*J7A$'(#b^a3ljT):,}@_T$2y'X_5UyNob-*d","K1EO+OHbq,!gENv$O(k@""axkj""KjaZXf#Z2/i{OY8K",1,2,5,3,skip
"t/""R*Az;@}_?#bx+!-kUF`LYn#Y7IBJLns:n?g","D][7/XY$3)_+ClBmcSt9#_~{r/LtFZ*;jjV.m""\1f:",3,3,6,3,skip
t=RF0)u]#l=Uf#vIBNOq_xP|5%;`z6DN$ccn?X,"1ri& Xv~.aDm6[""<CPfpk/$h,l1Q3a<^j)QdW?Ap6y",5,5,7,2,skip
t>!6d_j(M'<-q}m)R9` Q7>2H_`]spLXRuYV9j,mx6k)-~u[]xYjXVF?BET>JNZs[$FPN ZLR95]tBe[S,2,2,4,2,skip
t@mg\5D[8-dN024D$pqq=J5j3z;]]<RKfJ0}k8,~MiTt+cBY6MnGlou5I%AI mdRy6JL|Q]n;.GAAfm]M,2,2,4,2,skip
tCAJRhrI`X5/[RC7.v~x'd-krBZ9{dC$(;X/CZ,DHdGHwMbC/yk90Fe|.Vh|7|*|=4};iYkZsTZU+<RQI,2,2,4,2,skip
"tI7wx>hK#%<ew7LWq!_gF-##yy-tA%&*6""WG0n",u{}$6?qaD;$6{8}CqBsZzt<FsEAkzc?)r@`Rd=L)dJ,3,3,5,2,skip
"tI7wx>hK#%<ew7LWq!_gF-##yy-tA%&*6""WG0n",u{}$6?qaD;$6{8}CqBsZzt<FsEAkzc?)r@`Rd=L)dJ,6,7,9,2,skip
"tXGS$t1GSXWeHuzbd]n{5GQ#""G9rl?7JsA~x)J",XEO)$a*^;KwE{7JWc.k~iZKj60Y`mv+xFdMbi5T+ig,2,2,5,3,skip
"tYDR{""P:46D1&U<.iEf/S`2[;L4f9pX*|YYw?1",VG!ljkl1&[QP{zZ]U=|pdm8hQ;>=rM9$*{!2Er2LEo,13,12,14,2,skip
ta-G`.jb[3UpCL}thOYB:yUDoDH'@9?FkGe_Oo,".""9.JTx>#w%CoE6+j.K\""@C8ifr\vLc>==DOWl9[*k",4,4,9,5,skip
thrX:VJ 7pgeJBr(aO Sm`n2p4QMeq<<tyGkFF,x&$sN&l`\iWi8yk{tns25l1V1@J*AY&]@*Jw6L*t3],2,2,4,2,skip
"tjtpByb^mH)?4(,NA@vnkwvk8O5 Rprc$zfzju","<;'\jJ!(MS]O>8:{|i zsRkXN[:/Zk}@Sf>,t7\;;u",2,2,4,2,skip
"tw{8]<Mxz!hu1gJ{!H~(n=S)Z,>yGSyD{I@_pp",n0QJ#`/7Pmcr'&ljY-3CHk.O*Q6JZax(guk+%#36sN,7,7,9,2,skip
"tw{8]<Mxz!hu1gJ{!H~(n=S)Z,>yGSyD{I@_pp",n0QJ#`/7Pmcr'&ljY-3CHk.O*Q6JZax(guk+%#36sN,9,10,12,2,skip
t|'cavQ{9\Lw.%tW0n\4I~xGjE}t&Iu0Q1\2Rh,";v+Q;""\+dQ1=Q0>@X""BK[0hY|g9AN??YH3':;v9`}C",2,2,4,2,skip
u#8A2wf9*1by#6@bSBRRQ9ZPGmle'?#WdyWFLS,"3'QV/n,""N#E$=%69:],&uyNYE^pjhol7^$@a-!)W-\",7,6,8,2,skip
"u'8?a!kYM `ksp*zrkVG^`EW1;6lw,KWEN4(Vg",N+(m&bgA%dDRbad9_)`~&S~`4ogO[M0'=vM59HtEgv,1,19,21,2,skip
u-H;Lm:~vk+^g5`CW5Gn<N/d{hC`*M19'W|^Y4,"T47hxM`Me(39o_m}e.]^~_Ougd)3<,/vk) eQi.6&%",5,4,6,2,skip
"uAw`P;I=Hp`:=4<O&\+Z<v<U8-O^/0!xPRi0=,","^br kG+]zYw:{V$0_4ttXC',^""s?_QFy9 9d.Qpv+9",3,2,4,2,skip
"uAw`P;I=Hp`:=4<O&\+Z<v<U8-O^/0!xPRi0=,","^br kG+]zYw:{V$0_4ttXC',^""s?_QFy9 9d.Qpv+9",4,4,6,2,skip
uL`@O&CP13P8s`oFT;+wBi-[K9]0{*J|QcoW9|,&y7uC{tLX\y&!%7{5ofnB'11x7{w8p?q]u*E8xGyX$,1,1,6,5,skip
"uQ6GhdQ}gJ*)s}|OO_,zfXwc_;80!4s~#X|dS ",g>!JEQBo9_Ts&6q0W8/*zL!^1%iq1awD:2;pHbY`[K,1,1,3,2,skip
"uTL6&%z.C,Y9~3F12Q+#A=,)\0_JW^SWAWr~|$",:[>i~#Omv\Zl0HidAI{]7D2s!x]? R0'p!.xmKPKZ!,1,2,4,2,skip
"uYJ6|&$a&gzN0K*8+F|""xaU}:CI1J/h<X9_pZ'","V?WwGQNs,2xi(.XD'6W>MvZR>__%y9l""F.Wb4h4{[*",3,4,9,5,skip
"uZ,f@5vh-ekEUvv""9=$Z5ArQ3ok#w;i~=:@=~H","*1#ai]7Ae%^AcYUM>Pd""vQQ5CAM&%GUSr^`|be3i:*",3,4,6,2,skip
u^{)fsJ%!.W&#pGYWCM&;u!C{ul??X6_tbWF.q,"4a0]%'63Nj(V)E=l'0C,'sIZMT1FycV1[9rO3Lj,Qh",3,3,5,2,skip
u^{)fsJ%!.W&#pGYWCM&;u!C{ul??X6_tbWF.q,"4a0]%'63Nj(V)E=l'0C,'sIZMT1FycV1[9rO3Lj,Qh",7,8,10,2,skip
ui]OFR!.q]aD9{?)CRKw_H!LbOg}yc(FM{^$|p,luyBrmpYO2xuSY`^J6l`B}8A|#@G]6i]p2m>YgW0MH,2,2,4,2,skip
ui]OFR!.q]aD9{?)CRKw_H!LbOg}yc(FM{^$|p,luyBrmpYO2xuSY`^J6l`B}8A|#@G]6i]p2m>YgW0MH,3,4,6,2,skip
ui]OFR!.q]aD9{?)CRKw_H!LbOg}yc(FM{^$|p,luyBrmpYO2xuSY`^J6l`B}8A|#@G]6i]p2m>YgW0MH,4,6,8,2,skip
"ukopk]`>`7eFh^A{g13,:D""b;Udi>qJ.KC+ek%","8TN-NqD~!N\7.h/MUN""qf:?Fno 0@dh[*Y^W]_jgGY",1,1,3,2,skip
"v,0i[c#gS]D8zhJ]e7x*hl-FyLmhd*CG(opsW]",pQz+sqMT+KzTmhpRJ>dL[Hl$T$9L|PONOZLM1:F7\8,2,12,14,2,skip
"v1!7rpr#CNT?[;GM6@t>,7ir5v,wo%AhnhL8E$","{:&JpH@LF6xnN]yWvL""ch>nFL=rvie,x],/t`8@GMT",5,5,7,2,skip
"v>8aY^}CLf yUjr""qF(b|-#eHTP]tsL;tO'OJU",fHCa9f\Km_>MCl]hXoi5/Jr*k(G)Wq9!YOQ\2sV4&',3,3,5,2,skip
"vBK{q$Swt^e0l5guW,""cHHD+j?~%_@aG/NH%-R",zHh<] 4ew#y/(u*5c_TBZ~v7$e_lNyI1fy5io)g.>t,2,2,4,2,skip
"vIHF}^^C!P)Ya~p[$(d:G+J=uggoI|rjR0d""O7",]qr4_K%aBpWafC7S*7.fcF|(+;4=DWewNz\kZ!@:/W,3,2,4,2,skip
"vIHF}^^C!P)Ya~p[$(d:G+J=uggoI|rjR0d""O7",]qr4_K%aBpWafC7S*7.fcF|(+;4=DWewNz\kZ!@:/W,5,5,7,2,skip
"vjC+Nrdi#1,|yYaJn'-nRB&DEwk% wa 1F{H=P","PveD(|AtN&'Iv$a%UCJX'cE~.+fIEaj?7JdY""DR6?8",1,1,3,2,skip
vyH%JH.5~C&/G7@R2oy;#6>`*jvcBs?s2`bZl|,abfux9zyi/bW7mdaBmCnrLE\A)b|PL]S@*T$:Ln}i?,5,5,7,2,skip
vyH%JH.5~C&/G7@R2oy;#6>`*jvcBs?s2`bZl|,abfux9zyi/bW7mdaBmCnrLE\A)b|PL]S@*T$:Ln}i?,6,7,6,-1,reset
"v~n^!c-nD]YGsJ""^$zY3>`L{SP.FFT[&^(9{+d",il$b.]693xB.%>'{S4Ni&kO={WEaU$fQF\0~FYc1Ag,9,9,14,5,skip
"w#""/;5++J1VC\&MhI%\Oq.~HntcVnxp2biIDi8",#pd~>ncVdu&VfbIjpHGk%=#LkQQ+TUQn^'^ou]N0v/,3,3,5,2,skip
w.96Li#aF+ .MA<\S:>k%CSvD&}]PB&gg9a3~},5JQ`+*%7lQ)|(5p9lehe-j[kV4'vUGp/;HI;q7G}wr,4,2,4,2,skip
wC\i<@=V]4s^MblTC_d3o1}qf6Anp4 dK4)1CJ,"1:QT;tI>{/_L;?hI|*p~88Cu~cHyk""ZV$5R\&>~Q&K",4,4,6,2,skip
wC\i<@=V]4s^MblTC_d3o1}qf6Anp4 dK4)1CJ,"1:QT;tI>{/_L;?hI|*p~88Cu~cHyk""ZV$5R\&>~Q&K",6,7,9,2,skip
wC\i<@=V]4s^MblTC_d3o1}qf6Anp4 dK4)1CJ,"1:QT;tI>{/_L;?hI|*p~88Cu~cHyk""ZV$5R\&>~Q&K",7,9,11,2,skip
wC\i<@=V]4s^MblTC_d3o1}qf6Anp4 dK4)1CJ,"1:QT;tI>{/_L;?hI|*p~88Cu~cHyk""ZV$5R\&>~Q&K",8,11,13,2,skip
wC\i<@=V]4s^MblTC_d3o1}qf6Anp4 dK4)1CJ,"1:QT;tI>{/_L;?hI|*p~88Cu~cHyk""ZV$5R\&>~Q&K",12,16,18,2,skip
wC\i<@=V]4s^MblTC_d3o1}qf6Anp4 dK4)1CJ,~[hI..|84&AE;Sw-o<#|H!GTRU:^;B9|@>6SyUn}jD,4,4,6,2,skip
"wC_1uh1-[z45}~>b'<6|*4[s}0a/E"":{zO}t{G","n(L+EA@J3oQ[8vj-9,Wsw!yYO8psG|Z%2fqieuMcGD",2,2,4,2,skip
"wLm1CmI.[X?`"" +76orB'#Op1=e1r**q;Ri""4|","cmMQqv!Q|4nvMCLaf>TQ$w8YNqj;Zk@6,xa@\\')j=",1,6,5,-1,reset
"wLm1CmI.[X?`"" +76orB'#Op1=e1r**q;Ri""4|","cmMQqv!Q|4nvMCLaf>TQ$w8YNqj;Zk@6,xa@\\')j=",2,5,7,2,skip
"wce& b3\a|>;W{L2^Or(q]ZRZB-Z>XFkLB""6wq",u'5>}~5x5b1n^r0O)HB)T@&aJWTG{AIcuZ9D'ZWOr&,2,2,5,3,skip
"wc~tRH3SR0][^\=""]=zsr>5=-^i0&s^d{6%i{ ","Y|bu0(7vDlqq3|Q>D@x4vdP7_`b9)SWSp,H\+?x)2n",1,1,11,10,skip
"wex<\CVQ6K%Gh_ABM,%)O8"")>}|;4\$Y""%C1v-","akcI(bOP2QBRyHUoki)\y;#eW,S&ruV7iI3(F;Nx>C",4,3,5,2,skip
"wp1*am,?(Xlqpx/uy@uxehw_NRXakEleXxs^[~",'b:#[/0.6c/lR/Oxb^x$Rf(-)dtl%$BzbqSlgtf?o7,2,2,5,3,skip
wsgBEk1y/A%_+T{?d6A'qE+XKt[C^74<>y~bJ!,2it3QVR65Hy+e!&>HdAkJp%@`I]+c5<)%ro27j_1u),8,8,12,4,skip
"x#tI%pV$E[F h3W?V?F,/)gXNT mF""&8RoDf^A","K+\G2Cp,'ADK-yLdH5b)xCyCnz\]""D2# B%K'Ub\E&",2,2,4,2,skip
"x)>oznc8T""d,'CMWwe2Fc)l9VByjEN#oE2W6>e",GDX06%Bx]=I|E!p}On?q!%&%55<^-pHlxPF0E&0/*%,3,3,8,5,skip
x0N$r5UH|Z7s$g GAnvup|qxiMA.5~77'D->Z+,"KK_3LPz|:M:0+{~#3kbmzCvyN#{=#Z?\VA4?FB""?C@",5,3,6,3,skip
x4JA7LMw_2odS/C9Db Po-Ys+meNpmD$U);5Za,].h&q'x3J~bXUDb)D~-B>o0d O{Mg&AB$tS4W]v&uX,3,3,5,2,skip
x4JA7LMw_2odS/C9Db Po-Ys+meNpmD$U);5Za,].h&q'x3J~bXUDb)D~-B>o0d O{Mg&AB$tS4W]v&uX,5,6,8,2,skip
x4JA7LMw_2odS/C9Db Po-Ys+meNpmD$U);5Za,].h&q'x3J~bXUDb)D~-B>o0d O{Mg&AB$tS4W]v&uX,6,8,10,2,skip
x4JA7LMw_2odS/C9Db Po-Ys+meNpmD$U);5Za,].h&q'x3J~bXUDb)D~-B>o0d O{Mg&AB$tS4W]v&uX,8,11,13,2,skip
x4JA7LMw_2odS/C9Db Po-Ys+meNpmD$U);5Za,].h&q'x3J~bXUDb)D~-B>o0d O{Mg&AB$tS4W]v&uX,11,15,17,2,skip
x4JA7LMw_2odS/C9Db Po-Ys+meNpmD$U);5Za,].h&q'x3J~bXUDb)D~-B>o0d O{Mg&AB$tS4W]v&uX,12,17,19,2,skip
x4JA7LMw_2odS/C9Db Po-Ys+meNpmD$U);5Za,].h&q'x3J~bXUDb)D~-B>o0d O{Mg&AB$tS4W]v&uX,13,19,21,2,skip
"x4t?\5:Qu!mSHs,bk&E\.TB7'H?`wtvAFfUpt8",0Bl{#|FJbJ@D/8Er_#o$HDzlTW}[qVS16HUhC?Sy L,2,2,4,2,skip
"x4t?\5:Qu!mSHs,bk&E\.TB7'H?`wtvAFfUpt8",0Bl{#|FJbJ@D/8Er_#o$HDzlTW}[qVS16HUhC?Sy L,3,4,6,2,skip
"x4t?\5:Qu!mSHs,bk&E\.TB7'H?`wtvAFfUpt8",0Bl{#|FJbJ@D/8Er_#o$HDzlTW}[qVS16HUhC?Sy L,4,6,9,3,skip
"x5-,mvBoN1?C8aHMR*!`eOs] r;zI<l5rEV/FW","-*]@4,VaWZ9S$i1hc.tb}:USr8<A#EZ5ERma[ B|dW",3,3,5,2,skip
xBT-d5:N-/?&--p'[?ac+<6yLyYG$FHJp=~0.=,St4V>L=a~!.2v_OPsl}Oh.rmujee-(j>aL*T\I}|yS,3,3,5,2,skip
"xHw3H&gPsXAPWohig.Tafb0Ato4OE,DmBP~X|t",NNE+S_(|nJ@~EW)>s.}o oIY&e8oR~+qK66;akfT[U,5,5,7,2,skip
xMvnzUYzV#r^#Aa~-&jtU]Kie3b{4aIW#uA\U ,"1vbEWu72b.pPhtXs!v""{=$Lf)`&Ca,])ifV2@L`Eno",1,1,4,3,skip
xSE]@v`0`&+jS]T@o3qt)#g]/#4Ye\+Y<w~}HD,"XT><'DaJThL;w`07F1GDIJX-)K'[n^>""Nt)""3>Pe\c",2,2,4,2,skip
xSE]@v`0`&+jS]T@o3qt)#g]/#4Ye\+Y<w~}HD,"XT><'DaJThL;w`07F1GDIJX-)K'[n^>""Nt)""3>Pe\c",4,5,7,2,skip
"x]-b=jSNWLe5yf)&(ZaG{WIU|l&,-{=@<6iM[H","zvzs#:LgFc`8mi8e!Oq,qj:Xi.>xj5/pgrnvGtq5>I",2,2,4,2,skip
"x]-b=jSNWLe5yf)&(ZaG{WIU|l&,-{=@<6iM[H","zvzs#:LgFc`8mi8e!Oq,qj:Xi.>xj5/pgrnvGtq5>I",3,4,6,2,skip
xbyJb7@>l7yw864-v}I/1+tS+7+<X)dl>v[b>],"!#vPyOiayqTh hcTKov,L8f 7S,nny_K@;}zChVXzH",3,2,4,2,skip
xkc(]e'@@Xz/>(_^SWzN4{sj Lvf)UZ<sb}%j ,"c#Zj'2Z"">4p*)G'#/aApUaGk=kAbqm`1t8c""M<i a'",4,2,4,2,skip
xpEPJ;s]YZb-vmIX _jha&C$1Ia!z<b8H&\se8,">@zv_Pq.oqwtEA{&@,^@m`|$~0<15'3l)M0,?FKAe*",10,8,6,-2,reset
"xp^c/uDKx|07X9S{x0olNg,xuVv|6)t2o^G$fV","^G|f2o_hiD2>/G)].,9uK$fls5]k>mUv/P|&dY(.ih",2,2,4,2,skip
"xp^c/uDKx|07X9S{x0olNg,xuVv|6)t2o^G$fV","^G|f2o_hiD2>/G)].,9uK$fls5]k>mUv/P|&dY(.ih",3,4,6,2,skip
xrbEMq{ENGfN_n1AyAc=!NEdI!5c<y}t:.Ts{F,"|5_>H}V""Kzsq3>+dzLqHQM}6cQ3`oFw!)m2tmqodxA",1,1,3,2,skip
"xv>_{?6J89y]kt,J8KwK4P!iq1rpE kz- B#B9","Wv~6PGc MUPo^I,gl{vyd*e'y:RbC{NO""Y""ts6vX3`",1,2,9,7,skip
"xv>_{?6J89y]kt,J8KwK4P!iq1rpE kz- B#B9","Wv~6PGc MUPo^I,gl{vyd*e'y:RbC{NO""Y""ts6vX3`",3,10,12,2,skip
xyl_Eeh`Z80+HN$LYg/f7BNrEf&yBqE/n7|WW\,";&Jvr$F0!6Ktc8%?T}BE;?\$v_poTp#*7l""JfDD%0q",3,3,5,2,skip
xyl_Eeh`Z80+HN$LYg/f7BNrEf&yBqE/n7|WW\,";&Jvr$F0!6Ktc8%?T}BE;?\$v_poTp#*7l""JfDD%0q",4,5,4,-1,reset
xyl_Eeh`Z80+HN$LYg/f7BNrEf&yBqE/n7|WW\,";&Jvr$F0!6Ktc8%?T}BE;?\$v_poTp#*7l""JfDD%0q",5,4,6,2,skip
y&u;uIj9aA50b=zk(.NY\%`A46p3W>%M0N/ck4,"istxmiadERlY4iVcF+sb7B?jSYe_I:E*'.wvpD""v?\",2,3,5,2,skip
"y23 h)'@+!^OCt{@DW[K,>SGKA|Y[mB{5#Uj""x","u-sLk'(,/HcYw=CW?{w~{v$[9#G^Op~gPvt&4<gJhB",10,8,10,2,skip
yS #as0Je81#R*f:bn3Rd;T(sRA:^?vfg`iFh$,(cG({)1z~e7z?8ixI5BD6/8>fz18L5UxLDo0\fy*~1,2,2,4,2,skip
yd3r>@*+XyLVObuL]=4]jawL?uthR>dxC[|vXC,"b'l{+tXiaA'Cvc2+,0}w*,wbKEtMHKJ,uSt&DgnA2d",2,3,5,2,skip
"yt_<qvckJq_76Kfq.xMH16A{""LP:$>9RsUNPnh",k=> E001Zv)Dc(&ELfj])B(@r]50l*S?`6%3$u*v:;,2,2,4,2,skip
"z?,yr=Fm; -|RBG|)FrIKw8E:&-1YHio4d)M<,","K*y3-4?|@183u*NG%XpxI:2P@#<9,(UkP7Nmm,J@x3",3,12,14,2,skip
zDq<vz:J/6PXPx6)*wpKYA@zM9-IiPbT!W6/|~,"A6)e2MWCTojj:pkaR""Ypp8w4M.t GNecykF kN?2tv",2,2,4,2,skip
"zU=0bf~zo|U}W.rR/|dj*6""|B"" #rC,!|B|$gn","hkI@r!4yW+RsFr.l+6uNsTf""%/luDcrbA99&|g+&mH",2,2,4,2,skip
"zWWr hj(q{d\NMjWA'u2qOzfE-8eCR,XceN)q>",r:J)O/ rki*7#iXkLJfD\(7aA{{o(*9Tbgi-h3*hvs,3,3,6,3,skip
zY(WTWGOgPJ4_ :!#R0o4q*TBtP?6TH@6b{&+4,"|@jpU=5TM6VVg""V5P,bt.uW~Lq} (?8r(pl3 U@UjJ",2,2,5,3,skip
zY(WTWGOgPJ4_ :!#R0o4q*TBtP?6TH@6b{&+4,"|@jpU=5TM6VVg""V5P,bt.uW~Lq} (?8r(pl3 U@UjJ",3,5,8,3,skip
"z^RC_O!Y""TY/{?x#dw^k/%z*q)|RBP\_`hCvpY","&E%(VM#1Y<cVmXu&d?E6l,k/g^=rS|w15Cu\{?{KOJ",4,4,6,2,skip
"zzv!\2:[w^>u!lv$#eaa/:SOi(qDRM""2H`Kdw-","4?""8i0dP.PLg>nadk@Fj(3>j/mTK|aRS5{;KN*~$->",2,2,4,2,skip
"{""YE2R`kKN2JF)roZF!3R@O6io@+Q%CmwWvXYs","""ajk)&)`Qgyn~b4F1R(eA7`~n#2.{""{m6my9W#glf`",3,3,5,2,skip
"{)ScjiTa%Z!n#?4Y[23,?*yQT25YCu=UZI5yn`",L*k2!3*_#TBL{wAw%R2xKjwfaR1EjkiF{p-&&U9MV(,3,3,5,2,skip
"{)}|PK""k+tE6h(`0\=ndMYVr{x~bdEmz'ei|cI",R|3iXgu2 DStpH.)V^1r(Y9`)@qMY(Q7myJ/FKIz&?,3,3,5,2,skip
"{4xh'#gTjJfxWS6lxI<:&CB!vR#CUz,PXy%+Ig","Sv3Kh|^Ll=8$>eC15y?6F}vVC=""S$=>3{XvE7}}YM'",2,2,4,2,skip
"{L]'2e`qQ;EpCmIH[,xx(?zs+)Dcu5.;\E/U1/",QfGn5YBc0+-T~P|}:miyWMj(&%qG' Ke(GF&0*/mvY,2,2,4,2,skip
{h2:&^5r\3W -s1KzYK2MkYQ!1'@'2y\K0uhff,"v+I>.u-U""Z3>$Buj(GXCQzf}r8:K0m(Z6|,d:,1f1B",8,8,16,8,skip
"{kRbyLzm+JG1V'[Kd$XLifX?>-=G={$P;""NyG1",WOC_d$2 C+Ta!N0-cPC)lFLb-J68c+NtjL40A+ubO',2,3,5,2,skip
{s%ye;:95iO\ir{Yr;Ie/.>#6J)~&F8QwvheDR,?e5pU/wDihL&M6.7|o1pTxIT[?dOV>Y(f3`p~/x3yz,3,3,5,2,skip
"{v,q#Zk%{?$_V_)h[^],^>cDL%[4C9*]J,Oqkz",GAP{95Lz=nKzDlr13vzVp16l_}|=urcM*]+->eqIT!,7,7,9,2,skip
"{v,q#Zk%{?$_V_)h[^],^>cDL%[4C9*]J,Oqkz",GAP{95Lz=nKzDlr13vzVp16l_}|=urcM*]+->eqIT!,8,9,8,-1,reset
|#@3v`'-L<)SM2l0xZ081.cg&)46XAVw?<sOFH,"#=2=-;{Il0-:Zo>`jjV&A+tOKT4&($SnU7!zdNz},Y",6,2,4,2,skip
|&/8`t2wntkKBNjr[@n-q|2p]\<t0 =R<=`;T6,%&#qR5|T#Nu\[198DXi1'ei?o#I('-T' Q]=*([+Ca,2,2,4,2,skip
|&k+|0ijR&)~*pb@r'P:[G`j<=YS+-[d14EBd?,"9<FSA2Mx%2_wfL*9K;|""N!Bg:9~?x~PO|S2FNR@#!f",2,2,4,2,skip
"|,/%(""{,>L0xYQ K'FdPPzfPK(;!IHWo6bj|fe",B(M739p`RV~W4n}qf*5ayVu:*wDpoz~#)?Az;(/h 4,3,3,5,2,skip
"|,/%(""{,>L0xYQ K'FdPPzfPK(;!IHWo6bj|fe",B(M739p`RV~W4n}qf*5ayVu:*wDpoz~#)?Az;(/h 4,6,7,9,2,skip
"|9%1~p""Sg\Abm8zuU/_lS NQ\ d5Dko&HtZ|(?",+T~%<O;jP60'6f4>1<:k&RU9z.$\3//6r1R'%q:)m4,4,5,7,2,skip
"|B:JJ*/w~[-dr^%k6y,dV?9n-5opsP:2e"".P:8","_\NSKG`N0 RmaYd`/.,6I<Qb<NJJ=H05:4{@VK`,Y6",35,29,33,4,skip
"|JA7'A1bo&n)@:]]o,N-;3_b%$RSC""Yz ;\x.)",'M>&J^8(4$|j{]/|8LuZxqt|>6b~u5]8W2{8h{bz7c,5,3,6,3,skip
|LW;hG_JYU0`\zX*Y%.3g{p?8Bj[nGUWm92a@o,"mLHO:,\|8RQv;Cq.*]oT0.m\WQz4sYs4 V4[uBuCh]",2,2,4,2,skip
|P%9`B%B_Br]#9kzj?Sli(O[On5`x2^Az)6VE&,"4c]=pICfl8.KnbPl-G]Qul,yE$qUbwH-z,o{og)BOy",3,3,5,2,skip
"|rB8#1q7YhJ""5rzIHq}zJb^|n2aNzW3=0sOMpi",rP4G|Q>/_i NrQ@LXi]h6(1^}*dvxzoZ4ENa{Iqml;,3,3,7,4,skip
|uaVCcA[W]nfdJp&:N;aJTv![h[V('uM72eM0d,"Uq;`O,MOkqG%`z-^='eJWdCrf_K9POqMDioAK)Nt|m",3,2,4,2,skip
"|}Tm""06xoIPAr}5'68:`=I{iIwskU3<""z2U`}:",(Y4e(3(y2`\t&xJq-XAA>Nx0lE=T%=19* uuBJSo%c,1,1,4,3,skip
"}""-;ML""^e%)np2-5>'78%PU@j7`Jh8I&f~-xAJ","xClx8Uf5UgjyzIm@NI\Kv""gNp,Sss^e(A#Ai>i@U^w",2,2,4,2,skip
}6_$dZ1SVZ~R/|Ziv&`&8actN4Ej</;F=LG^=@,"xF""u_yq\*&m,ep}7LpT~:/BVXK&]fso8jXu+""vy'5f",1,3,5,2,skip
}BdG>;Wcgea^VAj9Xx /#\uKGY8L)eG0y@6K1n,M*^'U?79Bb%[+]Y)WqUZ|*%v9?+k%3a;CB`_SxS075,2,2,4,2,skip
"}DHB""NqGECDxV|zFbq[ZCb@lRf#[?plO^dW#`@","}ecKs/<X1[9zFWGRm1,oQ8z*L2)IZbgWUTv3RoCIPB",2,2,4,2,skip
}GlrJs0_:K1;8V(Q=l/b[sgLr[(c?[uGAIr5r8,"{d?!0Q!Q`sr}Ccz3?,]J4*3Uejz6\h0Hg\ Eim^rpm",4,4,7,3,skip
}I\$=n*y;.G9jRpma}5;E#NtlZyq\sl@BXwD~X,"u\+?W8sb^#N<}>IpQY<9\e=#""C{%r,{8]@HbH++ptM",2,2,4,2,skip
}I\$=n*y;.G9jRpma}5;E#NtlZyq\sl@BXwD~X,"u\+?W8sb^#N<}>IpQY<9\e=#""C{%r,{8]@HbH++ptM",3,4,6,2,skip
}T5>M_BtUI7Kgs<4Lorm>pq?{wEEq2/3kl3Xo;,7TqKOP>tFTv?gUx!{>\C]x^}ghQeg8<3VmEj+YN`?m,3,3,6,3,skip
}f>A&[p/}&mF2n~n4TcOMvpiaF7%DHPhu-VYZ<,"Abn X2K}k;C<$RhB \[;0TdcstGDUdM: >"")lu,Y?&",1,2,1,-1,reset
}f>A&[p/}&mF2n~n4TcOMvpiaF7%DHPhu-VYZ<,"Abn X2K}k;C<$RhB \[;0TdcstGDUdM: >"")lu,Y?&",2,1,3,2,skip
"}sXKte_KOrx7Gi(7-5y5K}/bt#J]T/cAI;*,{(",a6ZXD1y^Wn-XtRA\i+^%t`vll\w3]g|Nhl!oTj%7/1,3,3,5,2,skip
"}sXKte_KOrx7Gi(7-5y5K}/bt#J]T/cAI;*,{(",a6ZXD1y^Wn-XtRA\i+^%t`vll\w3]g|Nhl!oTj%7/1,4,5,7,2,skip
}zu2r]WkI:pTwAz]rbmoIk.G[Xs]D?G3 #9 P-,"6EsTwYg$ovdj_""*mWQ&s""I4#;qh-oS!NkmYRK]61Wd",2,2,5,3,skip
~*d88)N5ESY8FRGuPda^c80YS\!u_peY@{W~e\,"[rh4Dv07B<lf4,\lQYn!+'<Rf%9S>A_)N1;PXyd2x,",3,3,5,2,skip
"~,`y?|?ZuT5merZ<yi=""]&%*_T]*M]9+|qtVi|",b<O<CFh?8;i;$s!czmNS~ {jgp`pa] FDiw_M^pJW.,2,2,4,2,skip
"~7')<tUlxd.o3?X(""48-FYQ,BldMsl>Dc7.n4d",ms}(_f3U+6t-aRC[DJdI;-|pMRu)$zQ+6D!~b|&kJW,4,3,2,-1,reset
"~9""q{Z(0Q B(\_lnq<c3(Mss+GPjd{II|w40TI",Qo(-x.'EkE%oyrfPqmbG-iwfz@lUC2oCju7|FSR'B|,1,1,3,2,skip
~;Q>+P*nO\v!=BW?({O\.vZxBahcf6jxiTjM_7,">@oh#?ze,;w'lel|cyMX[nH=1 ?P-5/$r6Jb[N:/-_",1,2,4,2,skip
~?2|n~7-wpO8p.i:eK$$uMKmPej67G&I_]!UZd,':T?TSc7[yn^M6/)6N|~SL?oqDBd[(_qUmW1{K>!* ,5,5,7,2,skip
~N^7N }|0E/d#a1xf;]-fG5Q5>/c]L+nF'JW~;,"i,5_Ld);[KoAIM|Q[L_5`/]4deF-\{E!2{js3Wkpp/",2,2,4,2,skip
"~rk\OO,VK}-0xi1aQLU,xB:tPcnI2>=TXK~cS8","HxUP<|Z4XPOgix""|#etw_w@fZ|aWYhb^d/5(6zW$!'",9,7,9,2,skip
"~rk\OO,VK}-0xi1aQLU,xB:tPcnI2>=TXK~cS8","HxUP<|Z4XPOgix""|#etw_w@fZ|aWYhb^d/5(6zW$!'",10,9,8,-1,reset
"~rk\OO,VK}-0xi1aQLU,xB:tPcnI2>=TXK~cS8","HxUP<|Z4XPOgix""|#etw_w@fZ|aWYhb^d/5(6zW$!'",11,8,11,3,skip
"~rk\OO,VK}-0xi1aQLU,xB:tPcnI2>=TXK~cS8","HxUP<|Z4XPOgix""|#etw_w@fZ|aWYhb^d/5(6zW$!'",12,11,10,-1,reset
"~rk\OO,VK}-0xi1aQLU,xB:tPcnI2>=TXK~cS8","HxUP<|Z4XPOgix""|#etw_w@fZ|aWYhb^d/5(6zW$!'",13,10,12,2,skip
