time_interval,requests,unique_ips,bot_ratio,bot_count,human_count,is_anomaly
2024-10-01 00:00:00,13666,1931,0.046246158349187765,632,13034,False
2024-10-01 00:05:00,891,419,0.038159371492704826,34,857,True
2024-10-01 00:15:00,8758,1415,0.044073989495318565,386,8372,False
2024-10-01 00:20:00,14785,2028,0.05701724721001015,843,13942,False
2024-10-01 00:25:00,14141,1972,0.04136906866558235,585,13556,False
2024-10-01 00:30:00,14499,2134,0.03903717497758466,566,13933,False
2024-10-01 00:35:00,14902,2103,0.041269628237820426,615,14287,False
2024-10-01 00:40:00,6643,1288,0.04169802799939786,277,6366,False
2024-10-01 01:05:00,3090,827,0.04174757281553398,129,2961,False
2024-10-01 01:10:00,16153,2499,0.03052064631956912,493,15660,False
2024-10-01 01:15:00,17255,2549,0.039814546508258476,687,16568,False
2024-10-01 01:20:00,18116,2630,0.05111503643188342,926,17190,False
2024-10-01 01:25:00,23774,2610,0.033481955076974844,796,22978,False
2024-10-01 01:30:00,19336,2673,0.024358709143566405,471,18865,False
2024-10-01 01:35:00,18047,2723,0.021998116030365156,397,17650,False
2024-10-01 01:40:00,21165,2827,0.028395936687928183,601,20564,False
2024-10-01 01:45:00,37860,2924,0.026571579503433702,1006,36854,False
2024-10-01 01:50:00,30912,3015,0.02740036231884058,847,30065,False
2024-10-01 01:55:00,20360,3045,0.03732809430255403,760,19600,False
2024-10-01 02:00:00,21396,3168,0.03860534679379323,826,20570,False
2024-10-01 02:05:00,14680,2521,0.017302452316076293,254,14426,False
2024-10-01 02:10:00,21905,3182,0.04880164346039717,1069,20836,False
2024-10-01 02:15:00,21955,3282,0.030289227966294692,665,21290,False
2024-10-01 02:20:00,37871,3363,0.03741649283092604,1417,36454,False
2024-10-01 02:25:00,44144,3568,0.027455599855019934,1212,42932,False
2024-10-01 02:30:00,28348,3638,0.021659376322844644,614,27734,False
2024-10-01 02:35:00,24014,3839,0.01719830099108853,413,23601,False
2024-10-01 02:40:00,12163,2488,0.016854394475047274,205,11958,False
2024-10-01 02:55:00,18248,3179,0.02202981148619027,402,17846,False
2024-10-01 03:00:00,25752,4142,0.019105312208760484,492,25260,False
2024-10-01 03:05:00,26578,4324,0.019527428700428926,519,26059,False
2024-10-01 03:10:00,19534,3555,0.018429405139756324,360,19174,False
2024-10-01 03:15:00,12354,2288,0.018050833738060545,223,12131,False
2024-10-01 03:20:00,56824,4591,0.017422215965085176,990,55834,False
2024-10-01 03:25:00,57222,4709,0.01800006990318409,1030,56192,False
2024-10-01 03:30:00,36878,4848,0.02578773252345572,951,35927,False
2024-10-01 03:35:00,562,405,0.03914590747330961,22,540,True
2024-10-01 03:40:00,12695,2670,0.026545884206380464,337,12358,False
2024-10-01 03:45:00,41959,5081,0.019995710097952764,839,41120,False
2024-10-01 03:50:00,65492,5113,0.023789165088865815,1558,63934,False
2024-10-01 03:55:00,44821,5195,0.01999062939247228,896,43925,False
2024-10-01 04:00:00,49863,5363,0.019393137195916812,967,48896,False
2024-10-01 04:05:00,64114,5290,0.018841438687338178,1208,62906,False
2024-10-01 04:10:00,39137,5255,0.02322610317602269,909,38228,False
2024-10-01 04:15:00,14652,3746,0.027504777504777506,403,14249,False
2024-10-01 04:20:00,32375,5236,0.031598455598455595,1023,31352,False
2024-10-01 04:25:00,32743,5189,0.028189231286076415,923,31820,False
2024-10-01 04:30:00,14934,3684,0.02343645372974421,350,14584,False
2024-10-01 04:35:00,31148,5192,0.02366123025555413,737,30411,False
2024-10-01 04:40:00,31235,5097,0.042452377141027696,1326,29909,False
2024-10-01 04:45:00,16352,3349,0.020731409001956948,339,16013,False
2024-10-01 04:55:00,45554,4792,0.013698028713175572,624,44930,False
2024-10-01 05:00:00,60370,5201,0.02656948815636906,1604,58766,False
2024-10-01 05:05:00,49210,5221,0.028368217841902053,1396,47814,False
2024-10-01 05:10:00,25090,4472,0.031127939418094858,781,24309,False
2024-10-01 05:15:00,8886,1959,0.02903443619176232,258,8628,False
2024-10-01 05:20:00,87464,5387,0.01974526662398244,1727,85737,False
2024-10-01 05:25:00,59823,5409,0.02587633518880698,1548,58275,False
2024-10-01 05:30:00,18953,3635,0.03339840658470954,633,18320,False
2024-10-01 05:35:00,36941,3954,0.034785198018461874,1285,35656,False
2024-10-01 05:40:00,65428,5461,0.038362780460964724,2510,62918,False
2024-10-01 05:45:00,90414,5346,0.034187183400800764,3091,87323,False
2024-10-01 05:50:00,76038,5480,0.029537862647623557,2246,73792,False
2024-10-01 05:55:00,28882,4317,0.024201925074440828,699,28183,False
2024-10-01 06:10:00,855,561,0.05847953216374269,50,805,True
2024-10-01 06:15:00,30262,5329,0.028914149758773378,875,29387,False
2024-10-01 06:20:00,28942,5339,0.017103171860963304,495,28447,False
2024-10-01 06:25:00,29835,5348,0.019540807776101895,583,29252,False
2024-10-01 06:30:00,8410,2299,0.017479191438763378,147,8263,False
2024-10-01 06:35:00,21687,4266,0.007239359985244617,157,21530,False
2024-10-01 06:40:00,49619,5286,0.019105584554303796,948,48671,False
2024-10-01 06:45:00,58834,5252,0.022911921677941326,1348,57486,False
2024-10-01 06:50:00,45004,5186,0.017598435694604925,792,44212,False
2024-10-01 06:55:00,10630,2557,0.02991533396048918,318,10312,False
2024-10-01 07:00:00,23889,4505,0.017832475197789778,426,23463,False
2024-10-01 07:05:00,28761,5169,0.01839296269253503,529,28232,False
2024-10-01 07:10:00,28135,5257,0.009027901190687755,254,27881,False
2024-10-01 07:15:00,27418,5181,0.004230797286454154,116,27302,False
2024-10-01 07:20:00,37639,5136,0.006562342251388188,247,37392,False
2024-10-01 07:25:00,40172,5096,0.014861097281688739,597,39575,False
2024-10-01 07:30:00,28867,5254,0.016593341878269306,479,28388,False
2024-10-01 07:35:00,27952,5160,0.016277904979965657,455,27497,False
2024-10-01 07:40:00,2351,1089,0.02126754572522331,50,2301,False
2024-10-01 07:45:00,18849,3942,0.012202238845562098,230,18619,False
2024-10-01 07:50:00,27290,5128,0.01487724441187248,406,26884,False
2024-10-01 07:55:00,44165,5092,0.010823049926412318,478,43687,False
2024-10-01 08:00:00,51755,5092,0.02046179113129166,1059,50696,False
2024-10-01 08:05:00,28410,5199,0.01872580077437522,532,27878,False
2024-10-01 08:10:00,28752,5177,0.025563439065108513,735,28017,False
2024-10-01 08:15:00,29471,5178,0.025652336194903463,756,28715,False
2024-10-01 08:20:00,59672,5316,0.022288510524198953,1330,58342,False
2024-10-01 08:25:00,31679,5267,0.009091196060481707,288,31391,False
2024-10-01 08:30:00,29857,5326,0.023646046153330876,706,29151,False
2024-10-01 08:35:00,31366,5452,0.02394312312695275,751,30615,False
2024-10-01 08:40:00,30194,5407,0.021328740809432336,644,29550,False
2024-10-01 08:45:00,21564,4186,0.020311630495269895,438,21126,False
2024-10-01 08:50:00,5915,1797,0.03482671174978867,206,5709,False
2024-10-01 08:55:00,31133,5596,0.02164905405839463,674,30459,False
2024-10-01 09:00:00,31703,5673,0.02577043182033246,817,30886,False
2024-10-01 09:05:00,24015,4880,0.02623360399750156,630,23385,False
2024-10-01 09:10:00,32296,5560,0.045795144909586326,1479,30817,False
2024-10-01 09:15:00,57008,5498,0.04206427168116755,2398,54610,False
2024-10-01 09:20:00,39969,5532,0.026520553428907405,1060,38909,False
2024-10-01 09:25:00,32579,5709,0.027410294975290832,893,31686,False
2024-10-01 09:30:00,8982,2402,0.01681140057893565,151,8831,False
2024-10-01 09:35:00,22174,3218,0.028952827635970055,642,21532,False
2024-10-01 09:40:00,41789,5945,0.024791212998636004,1036,40753,False
2024-10-01 09:45:00,9765,2329,0.018433179723502304,180,9585,False
2024-10-01 09:50:00,49656,4786,0.016070565490575155,798,48858,False
2024-10-01 09:55:00,85067,5926,0.011767195269611012,1001,84066,False
2024-10-01 10:00:00,67689,5806,0.011803985876582606,799,66890,False
2024-10-01 10:05:00,63205,5757,0.01241990348864805,785,62420,False
2024-10-01 10:10:00,39922,5299,0.01988878312709784,794,39128,False
2024-10-01 10:15:00,49034,5800,0.01861973324631888,913,48121,False
2024-10-01 10:20:00,17011,3712,0.01404973252601258,239,16772,False
2024-10-01 10:25:00,40876,5811,0.011180154613954399,457,40419,False
2024-10-01 10:30:00,29908,4819,0.018356292630734253,549,29359,False
2024-10-01 10:35:00,8715,2181,0.019162363740676994,167,8548,False
2024-10-01 10:40:00,58499,5628,0.010017265252397477,586,57913,False
2024-10-01 10:45:00,66520,5708,0.010914010823812386,726,65794,False
2024-10-01 10:50:00,30106,4673,0.019132398857370624,576,29530,False
2024-10-01 11:05:00,28330,5253,0.012530885986586656,355,27975,False
2024-10-01 11:10:00,33908,5901,0.013536628524242067,459,33449,False
2024-10-01 11:15:00,27874,5088,0.012735882901628758,355,27519,False
2024-10-01 11:20:00,29259,5351,0.025462250931337367,745,28514,False
2024-10-01 11:25:00,40122,6951,0.024076566472259607,966,39156,False
2024-10-01 11:30:00,39563,6875,0.020498951040113237,811,38752,False
2024-10-01 11:35:00,39827,7024,0.018881663193311072,752,39075,False
2024-10-01 11:40:00,33968,6617,0.019842204427696655,674,33294,False
2024-10-01 11:45:00,40108,6902,0.01812605963897477,727,39381,False
2024-10-01 11:50:00,21551,5086,0.02190153589160596,472,21079,False
2024-10-01 11:55:00,36986,6320,0.025279835613475368,935,36051,False
2024-10-01 12:00:00,35235,5969,0.03709379877962254,1307,33928,False
2024-10-01 12:05:00,11496,3402,0.03627348643006263,417,11079,False
2024-10-01 12:10:00,106743,6018,0.02498524493409404,2667,104076,False
2024-10-01 12:15:00,100242,6018,0.025677859579816845,2574,97668,False
2024-10-01 12:20:00,72256,6188,0.01974922497785651,1427,70829,False
2024-10-01 12:25:00,36685,6227,0.02496933351506065,916,35769,False
2024-10-01 12:30:00,36803,6279,0.03404613754313507,1253,35550,False
2024-10-01 12:35:00,37956,6352,0.04326061755717146,1642,36314,False
2024-10-01 12:40:00,36573,6300,0.028299565253055534,1035,35538,False
2024-10-01 12:45:00,32079,6081,0.023660338539231274,759,31320,False
2024-10-01 12:50:00,40955,6736,0.02869002563789525,1175,39780,False
2024-10-01 12:55:00,63730,6816,0.029091479679899578,1854,61876,False
2024-10-01 13:00:00,42241,6989,0.036481143912312684,1541,40700,False
2024-10-01 13:05:00,41647,7125,0.034744399356496265,1447,40200,False
2024-10-01 13:10:00,33930,6545,0.02852932508104922,968,32962,False
2024-10-01 13:15:00,43989,7778,0.019527609175021027,859,43130,False
2024-10-01 13:20:00,43821,7915,0.01903197097282125,834,42987,False
2024-10-01 13:25:00,19295,4878,0.02026431718061674,391,18904,False
2024-10-01 13:30:00,42087,7743,0.019198327274455296,808,41279,False
2024-10-01 13:35:00,44796,7377,0.019912492186802393,892,43904,False
2024-10-01 13:40:00,93510,8188,0.01894984493637044,1772,91738,False
2024-10-01 13:45:00,57849,7602,0.01979290912548186,1145,56704,False
2024-10-01 13:50:00,47855,8293,0.017364956639849546,831,47024,False
2024-10-01 13:55:00,70940,8404,0.013955455314350156,990,69950,False
2024-10-01 14:00:00,46087,8194,0.019376396814719987,893,45194,False
2024-10-01 14:05:00,15797,4747,0.018357916060011394,290,15507,False
2024-10-01 14:10:00,89412,8527,0.013119044423567306,1173,88239,False
2024-10-01 14:15:00,87246,8705,0.012997730554982464,1134,86112,False
2024-10-01 14:20:00,57589,9043,0.014742398721978156,849,56740,False
2024-10-01 14:25:00,39935,7726,0.013972705646675848,558,39377,False
2024-10-01 14:30:00,28268,6020,0.009197679354747417,260,28008,False
2024-10-01 14:35:00,102114,9662,0.008568854417611689,875,101239,False
2024-10-01 14:40:00,49842,6857,0.007242887524577665,361,49481,False
2024-10-01 14:50:00,29502,6310,0.015524371229069215,458,29044,False
2024-10-01 14:55:00,44226,8352,0.013747569303124858,608,43618,False
2024-10-01 15:00:00,16346,4266,0.014254251804722867,233,16113,False
2024-10-01 15:05:00,63340,10058,0.010183138616987686,645,62695,False
2024-10-01 15:10:00,119922,11488,0.009606244058638115,1152,118770,False
2024-10-01 15:15:00,72433,11647,0.008242099595488245,597,71836,False
2024-10-01 15:20:00,55639,10237,0.010711910710113409,596,55043,False
2024-10-01 15:30:00,44451,8798,0.011000877370587839,489,43962,False
2024-10-01 15:35:00,73295,10666,0.008240671259976805,604,72691,False
2024-10-01 15:40:00,123100,11662,0.0057920389926888706,713,122387,False
2024-10-01 15:45:00,91596,11582,0.007860605266605529,720,90876,False
2024-10-01 15:50:00,102693,11647,0.010507045270855851,1079,101614,False
2024-10-01 15:55:00,52563,10390,0.012004642048589313,631,51932,False
2024-10-01 16:00:00,92312,11588,0.017397521448999045,1606,90706,False
2024-10-01 16:05:00,55144,9908,0.012820977803568837,707,54437,False
2024-10-01 16:10:00,44815,8436,0.013053665067499722,585,44230,False
2024-10-01 16:15:00,102213,12864,0.011299932493909776,1155,101058,False
2024-10-01 16:20:00,71129,12531,0.011429937156434084,813,70316,False
2024-10-01 16:25:00,83828,13416,0.009877367943885098,828,83000,False
2024-10-01 16:30:00,80469,13635,0.011308702730243946,910,79559,False
2024-10-01 16:35:00,71966,13138,0.012116832948892533,872,71094,False
2024-10-01 16:40:00,102844,13363,0.00905254560304928,931,101913,False
2024-10-01 16:45:00,83685,13628,0.0076477265937742725,640,83045,False
2024-10-01 16:50:00,76460,13198,0.009050483913157206,692,75768,False
2024-10-01 16:55:00,62709,10814,0.008706884179304406,546,62163,False
2024-10-01 17:05:00,54430,9727,0.009994488333639537,544,53886,False
2024-10-01 17:10:00,63570,12055,0.007802422526348907,496,63074,False
2024-10-01 17:15:00,45840,8905,0.005017452006980803,230,45610,False
2024-10-01 17:20:00,49365,7219,0.00840676592727641,415,48950,False
2024-10-01 17:25:00,379738,15126,0.007784314448382832,2956,376782,True
2024-10-01 17:30:00,104201,10916,0.008541184825481522,890,103311,False
2024-10-01 17:35:00,310852,14502,0.008042412466382716,2500,308352,True
2024-10-01 17:40:00,104466,13111,0.006557157352631478,685,103781,False
2024-10-01 17:45:00,128628,14197,0.006079547221444786,782,127846,False
2024-10-01 17:50:00,61329,10918,0.006293922940207732,386,60943,False
2024-10-01 17:55:00,74813,13938,0.004397631427693048,329,74484,False
2024-10-01 18:00:00,65493,12677,0.006397630281098744,419,65074,False
2024-10-01 18:05:00,65579,11654,0.007929367632931273,520,65059,False
2024-10-01 18:15:00,62395,11147,0.00533696610305313,333,62062,False
2024-10-01 18:20:00,71219,12663,0.005223325236243137,372,70847,False
2024-10-01 18:25:00,38418,7544,0.004451038575667656,171,38247,False
2024-10-01 18:35:00,174613,14273,0.004907996540921925,857,173756,True
2024-10-01 18:40:00,43473,9864,0.006739815517677639,293,43180,False
2024-10-01 18:45:00,97130,14888,0.005734582518274477,557,96573,False
2024-10-01 18:50:00,170338,15416,0.004080123049466355,695,169643,True
2024-10-01 18:55:00,190715,15728,0.00339249665731589,647,190068,True
2024-10-01 19:00:00,86261,12111,0.005761584029862858,497,85764,False
2024-10-01 19:05:00,244215,17654,0.00748111295374977,1827,242388,True
2024-10-01 19:10:00,124844,17590,0.0046858479382269076,585,124259,False
2024-10-01 19:15:00,89265,14660,0.005534083907466532,494,88771,False
2024-10-01 19:30:00,46592,8114,0.012427026098901098,579,46013,False
2024-10-01 19:35:00,89784,12942,0.0090884790163058,816,88968,False
2024-10-01 19:40:00,81920,11597,0.0053955078125,442,81478,False
2024-10-01 19:45:00,93034,11927,0.006653481522884107,619,92415,False
2024-10-01 19:50:00,90098,10962,0.007935803236475837,715,89383,False
2024-10-01 19:55:00,68491,9517,0.0106291337547999,728,67763,False
2024-10-01 20:00:00,55494,8735,0.0151367715428695,840,54654,False
2024-10-01 20:05:00,67312,8541,0.014945329213216068,1006,66306,False
2024-10-01 20:10:00,76925,8807,0.012076698082547936,929,75996,False
2024-10-01 20:15:00,61149,8254,0.01172545748908404,717,60432,False
2024-10-01 20:20:00,48291,7203,0.008096746805823032,391,47900,False
2024-10-01 20:25:00,33880,6024,0.012249114521841794,415,33465,False
2024-10-01 20:30:00,57407,7423,0.010556203947253819,606,56801,False
2024-10-01 20:35:00,52497,6939,0.013181705621273597,692,51805,False
2024-10-01 20:40:00,64480,6920,0.014934863523573202,963,63517,False
2024-10-01 20:45:00,83679,6713,0.014842433585487399,1242,82437,False
2024-10-01 20:50:00,61906,6539,0.013342810066875585,826,61080,False
2024-10-01 20:55:00,59158,7518,0.01387808918489469,821,58337,False
2024-10-01 21:00:00,46076,6085,0.016646410278670025,767,45309,False
2024-10-01 21:05:00,38760,5232,0.017311661506707945,671,38089,False
2024-10-01 21:10:00,44160,4833,0.020516304347826086,906,43254,False
2024-10-01 21:15:00,46189,4384,0.02485440256338089,1148,45041,False
2024-10-01 21:20:00,55285,3937,0.02083747852039432,1152,54133,False
2024-10-01 21:25:00,28091,3877,0.010501584137268163,295,27796,False
2024-10-01 21:30:00,27108,3664,0.016305149771285228,442,26666,False
2024-10-01 21:35:00,7472,1569,0.030380085653104925,227,7245,False
2024-10-01 21:40:00,9601,1748,0.04041245703572544,388,9213,False
2024-10-01 21:45:00,23823,3100,0.029425345254585903,701,23122,False
2024-10-01 21:50:00,43630,2939,0.030071052028420812,1312,42318,False
2024-10-01 21:55:00,42098,2833,0.03415839232267566,1438,40660,False
2024-10-01 22:00:00,26402,2844,0.02855844254223165,754,25648,False
2024-10-01 22:05:00,20755,2709,0.03946037099494098,819,19936,False
2024-10-01 22:10:00,13915,1999,0.038663312971613364,538,13377,False
2024-10-01 22:15:00,9039,1528,0.032525721871888486,294,8745,False
2024-10-01 22:20:00,19429,2597,0.030469916104791807,592,18837,False
2024-10-01 22:25:00,18915,2554,0.036214644462067146,685,18230,False
2024-10-01 22:30:00,18437,2550,0.0352551933611759,650,17787,False
2024-10-01 22:35:00,16100,2237,0.03975155279503106,640,15460,False
2024-10-01 22:55:00,6144,1243,0.041178385416666664,253,5891,False
2024-10-01 23:00:00,26858,2535,0.0346265544716658,930,25928,False
2024-10-01 23:05:00,35300,2412,0.028838526912181302,1018,34282,False
2024-10-01 23:10:00,33296,2301,0.0239067755886593,796,32500,False
2024-10-01 23:15:00,33582,2309,0.02596629146566613,872,32710,False
2024-10-01 23:20:00,23736,2384,0.03046006066734075,723,23013,False
2024-10-01 23:25:00,17670,2362,0.02874929258630447,508,17162,False
2024-10-01 23:30:00,18438,2380,0.032921141121596706,607,17831,False
2024-10-01 23:35:00,17994,2343,0.03984661553851284,717,17277,False
2024-10-01 23:40:00,17504,2364,0.031021480804387568,543,16961,False
2024-10-01 23:45:00,21518,2454,0.02639650525141742,568,20950,False
2024-10-01 23:50:00,31178,2362,0.030213612162422222,942,30236,False
2024-10-01 23:55:00,18648,2427,0.03244315744315744,605,18043,False
2024-10-02 00:00:00,18729,2456,0.03710822788189439,695,18034,False
2024-10-02 00:05:00,18419,2363,0.041044573538194254,756,17663,False
2024-10-02 00:10:00,18359,2390,0.03709352361239719,681,17678,False
2024-10-02 00:15:00,18245,2373,0.03787338996985475,691,17554,False
2024-10-02 00:20:00,18997,2448,0.03316313102068748,630,18367,False
2024-10-02 00:25:00,19647,2535,0.03389830508474576,666,18981,False
2024-10-02 00:30:00,14230,2079,0.02445537596626845,348,13882,False
2024-10-02 00:35:00,12316,1812,0.04100357258850276,505,11811,False
2024-10-02 00:40:00,19877,2519,0.03999597524777381,795,19082,False
2024-10-02 00:45:00,20244,2604,0.030280576961074886,613,19631,False
2024-10-02 00:50:00,20165,2685,0.02925861641457972,590,19575,False
2024-10-02 00:55:00,1126,545,0.02486678507992895,28,1098,True
2024-10-02 01:10:00,15955,2306,0.029896584142901913,477,15478,False
2024-10-02 01:15:00,23478,2998,0.029048470908936024,682,22796,False
2024-10-02 01:20:00,24402,3201,0.022375215146299483,546,23856,False
2024-10-02 01:25:00,9893,1777,0.026180127362781764,259,9634,False
2024-10-02 01:35:00,23489,3094,0.026906211418110604,632,22857,False
2024-10-02 01:40:00,26956,3384,0.030160261166345154,813,26143,False
2024-10-02 01:45:00,27955,3491,0.026006081201931677,727,27228,False
2024-10-02 01:50:00,12457,2667,0.02761499558481175,344,12113,False
2024-10-02 01:55:00,28223,3628,0.023739503242036636,670,27553,False
2024-10-02 02:00:00,29764,3752,0.03050665233167585,908,28856,False
2024-10-02 02:05:00,30560,3769,0.030333769633507854,927,29633,False
2024-10-02 02:10:00,31137,3926,0.025981950733853613,809,30328,False
2024-10-02 02:15:00,65745,4080,0.01667046923720435,1096,64649,False
2024-10-02 02:20:00,32531,4160,0.01825950631705143,594,31937,False
2024-10-02 02:25:00,40075,4167,0.01734248284466625,695,39380,False
2024-10-02 02:30:00,38217,4284,0.015987649475364366,611,37606,False
2024-10-02 02:35:00,27883,3833,0.027722985331564035,773,27110,False
2024-10-02 02:40:00,27360,3778,0.019846491228070175,543,26817,False
2024-10-02 02:45:00,34054,4592,0.008222235273389323,280,33774,False
2024-10-02 02:50:00,20506,3237,0.008826684872720179,181,20325,False
2024-10-02 02:55:00,1513,836,0.027098479841374753,41,1472,False
2024-10-02 03:00:00,38699,5016,0.021189178014935785,820,37879,False
2024-10-02 03:05:00,40387,5165,0.021293980736375565,860,39527,False
2024-10-02 03:10:00,40652,5218,0.02012201121716029,818,39834,False
2024-10-02 03:15:00,41416,5475,0.02250338033610199,932,40484,False
2024-10-02 03:20:00,17557,3136,0.0174859030586091,307,17250,False
2024-10-02 03:25:00,39053,5279,0.014493124727933834,566,38487,False
2024-10-02 03:30:00,41957,5754,0.014443358676740473,606,41351,False
2024-10-02 03:35:00,26525,4621,0.01579641847313855,419,26106,False
2024-10-02 03:40:00,42244,5953,0.013374680427989774,565,41679,False
2024-10-02 03:45:00,18624,4243,0.013799398625429553,257,18367,False
2024-10-02 03:50:00,42485,5985,0.013369424502765683,568,41917,False
2024-10-02 03:55:00,34872,5214,0.010954347327368663,382,34490,False
2024-10-02 04:00:00,57056,5833,0.015002804262478967,856,56200,False
2024-10-02 04:05:00,84261,6078,0.017956112555037325,1513,82748,False
2024-10-02 04:10:00,68008,6242,0.014910010586989765,1014,66994,False
2024-10-02 04:15:00,42446,6149,0.010201196814776423,433,42013,False
2024-10-02 04:20:00,42198,6238,0.01210957865301673,511,41687,False
2024-10-02 04:25:00,41858,6202,0.010559510726742797,442,41416,False
2024-10-02 04:30:00,41178,6069,0.008232551362377969,339,40839,False
2024-10-02 04:35:00,32595,5172,0.010032213529682466,327,32268,False
2024-10-02 04:45:00,36147,5581,0.011508562259661936,416,35731,False
2024-10-02 04:50:00,40530,5988,0.015963483839131508,647,39883,False
2024-10-02 04:55:00,2836,1297,0.022566995768688293,64,2772,False
2024-10-02 05:00:00,32850,5205,0.016225266362252664,533,32317,False
2024-10-02 05:05:00,37935,5920,0.008092790299195993,307,37628,False
2024-10-02 05:10:00,11135,2702,0.007543780871127077,84,11051,False
2024-10-02 05:15:00,24907,4349,0.010719877945958967,267,24640,False
2024-10-02 05:20:00,38419,5836,0.015122725734662537,581,37838,False
2024-10-02 05:25:00,12673,3295,0.013808885031168627,175,12498,False
2024-10-02 05:30:00,41301,5764,0.014527493281034358,600,40701,False
2024-10-02 05:35:00,38204,5778,0.016150141346455867,617,37587,False
2024-10-02 05:40:00,24720,4361,0.005744336569579288,142,24578,False
2024-10-02 05:45:00,35004,5470,0.01425551365558222,499,34505,False
2024-10-02 05:50:00,36858,5757,0.019670085191817243,725,36133,False
2024-10-02 05:55:00,35842,5668,0.018581552368729423,666,35176,False
2024-10-02 06:00:00,34814,5546,0.02102602401332797,732,34082,False
2024-10-02 06:05:00,35210,5565,0.014598125532519171,514,34696,False
2024-10-02 06:10:00,33854,5568,0.0075618833815797246,256,33598,False
2024-10-02 06:15:00,34521,5589,0.009182816256771241,317,34204,False
2024-10-02 06:20:00,35228,5800,0.0080617690473487,284,34944,False
2024-10-02 06:25:00,35209,5775,0.013008037717629015,458,34751,False
2024-10-02 06:30:00,34369,5607,0.009979923768512321,343,34026,False
2024-10-02 06:35:00,33033,5527,0.004722550177095631,156,32877,False
2024-10-02 06:40:00,17466,3510,0.014027252948585823,245,17221,False
2024-10-02 06:45:00,31624,5283,0.021154819124715406,669,30955,False
2024-10-02 06:50:00,62977,5338,0.02156342791812884,1358,61619,False
2024-10-02 06:55:00,115789,5484,0.020373265163357485,2359,113430,False
2024-10-02 07:00:00,95406,5350,0.011571599270486134,1104,94302,False
2024-10-02 07:05:00,104333,5342,0.01651442975856153,1723,102610,False
2024-10-02 07:10:00,63049,5405,0.01868388079113071,1178,61871,False
2024-10-02 07:15:00,42011,5377,0.012829973102282736,539,41472,False
2024-10-02 07:20:00,31185,5263,0.010421677088343755,325,30860,False
2024-10-02 07:25:00,30533,5288,0.015098418105001146,461,30072,False
2024-10-02 07:30:00,31513,5340,0.019071494303938057,601,30912,False
2024-10-02 07:35:00,30678,5181,0.021741964926005608,667,30011,False
2024-10-02 07:40:00,29986,5074,0.018708730741012473,561,29425,False
2024-10-02 07:45:00,16401,3320,0.012560209743308334,206,16195,False
2024-10-02 07:50:00,29698,5128,0.01181897770893663,351,29347,False
2024-10-02 07:55:00,27629,4849,0.02015997683593326,557,27072,False
2024-10-02 08:00:00,25129,4500,0.02379720641489912,598,24531,False
2024-10-02 08:05:00,29427,5120,0.019403948754545146,571,28856,False
2024-10-02 08:10:00,19172,3735,0.01768203630294179,339,18833,False
2024-10-02 08:15:00,28514,4985,0.010977063898435856,313,28201,False
2024-10-02 08:20:00,29674,5125,0.015164790725887983,450,29224,False
2024-10-02 08:25:00,30307,5168,0.019665423829478338,596,29711,False
2024-10-02 08:30:00,29789,4928,0.02135016281177616,636,29153,False
2024-10-02 08:35:00,30537,5126,0.018731375053214133,572,29965,False
2024-10-02 08:40:00,31235,5180,0.018088682567632464,565,30670,False
2024-10-02 08:45:00,29472,5024,0.019985070575461453,589,28883,False
2024-10-02 08:50:00,30871,5189,0.020893395095720902,645,30226,False
2024-10-02 08:55:00,31564,5256,0.019452540869344823,614,30950,False
2024-10-02 09:00:00,29933,5081,0.022216283032105034,665,29268,False
2024-10-02 09:05:00,29674,5215,0.018130349801172743,538,29136,False
2024-10-02 09:10:00,31209,5372,0.014322791502451216,447,30762,False
2024-10-02 09:15:00,30326,5310,0.01328892699333905,403,29923,False
2024-10-02 09:20:00,32429,5456,0.016220049955286933,526,31903,False
2024-10-02 09:25:00,29963,5339,0.0023362146647531957,70,29893,False
2024-10-02 09:30:00,17599,3517,0.021762600147735667,383,17216,False
2024-10-02 09:35:00,22430,4201,0.019839500668747213,445,21985,False
2024-10-02 09:40:00,31524,5427,0.01909656135008248,602,30922,False
2024-10-02 09:45:00,31276,5540,0.015283284307456197,478,30798,False
2024-10-02 09:50:00,31188,5500,0.011991791714762088,374,30814,False
2024-10-02 09:55:00,32198,5581,0.017734020746630226,571,31627,False
2024-10-02 10:00:00,23885,4868,0.02993510571488382,715,23170,False
2024-10-02 10:05:00,31833,5364,0.023906009487010334,761,31072,False
2024-10-02 10:10:00,30936,5395,0.01616239979312128,500,30436,False
2024-10-02 10:15:00,31143,5429,0.018720097614231126,583,30560,False
2024-10-02 10:20:00,31871,5575,0.020018198362147407,638,31233,False
2024-10-02 10:25:00,33991,5721,0.02874290253302345,977,33014,False
2024-10-02 10:30:00,23701,4939,0.016328424960972112,387,23314,False
2024-10-02 10:35:00,32104,5645,0.01544978818838774,496,31608,False
2024-10-02 10:40:00,41159,5847,0.014237469326271289,586,40573,False
2024-10-02 10:45:00,33197,5815,0.016236406904238335,539,32658,False
2024-10-02 10:50:00,33957,5961,0.021998409753511795,747,33210,False
2024-10-02 10:55:00,24417,5033,0.023672031781136093,578,23839,False
2024-10-02 11:00:00,31637,5628,0.026519581502670923,839,30798,False
2024-10-02 11:05:00,33423,5887,0.018609939263381503,622,32801,False
2024-10-02 11:10:00,33959,5961,0.018522335757825612,629,33330,False
2024-10-02 11:15:00,34635,6162,0.02176988595351523,754,33881,False
2024-10-02 11:20:00,18438,4241,0.02337563727085367,431,18007,False
2024-10-02 11:25:00,34799,6139,0.019540791402051783,680,34119,False
2024-10-02 11:30:00,40980,6289,0.022645192776964373,928,40052,False
2024-10-02 11:35:00,34083,6079,0.017457383446292874,595,33488,False
2024-10-02 11:40:00,44940,6239,0.01065865598575879,479,44461,False
2024-10-02 11:45:00,42769,6317,0.013537842830087212,579,42190,False
2024-10-02 11:50:00,36404,6347,0.01856938797934293,676,35728,False
2024-10-02 11:55:00,30967,5648,0.02389640585139019,740,30227,False
2024-10-02 12:00:00,72338,6392,0.027067378141502393,1958,70380,False
2024-10-02 12:05:00,67910,6308,0.015373288175526433,1044,66866,False
2024-10-02 12:10:00,26300,5501,0.014296577946768061,376,25924,False
2024-10-02 12:15:00,38409,6650,0.0217657319898982,836,37573,False
2024-10-02 12:20:00,38524,6651,0.02453016301526321,945,37579,False
2024-10-02 12:25:00,39080,6917,0.011028659160696008,431,38649,False
2024-10-02 12:30:00,40550,7233,0.008360049321824908,339,40211,False
2024-10-02 12:35:00,5695,2136,0.00877963125548727,50,5645,False
2024-10-02 12:40:00,33683,6345,0.011489475403022297,387,33296,False
2024-10-02 12:45:00,40229,7209,0.009470779785726715,381,39848,False
2024-10-02 12:50:00,72199,7441,0.024958794443136333,1802,70397,False
2024-10-02 12:55:00,82489,7652,0.020439088848210066,1686,80803,False
2024-10-02 13:00:00,33597,7213,0.007381611453403577,248,33349,False
2024-10-02 13:05:00,43350,7881,0.007104959630911188,308,43042,False
2024-10-02 13:10:00,37852,7757,0.01122794039945049,425,37427,False
2024-10-02 13:15:00,46619,8583,0.006478045432119951,302,46317,False
2024-10-02 13:20:00,47457,8653,0.00815475061634743,387,47070,False
2024-10-02 13:25:00,47530,8601,0.01245529139490848,592,46938,False
2024-10-02 13:30:00,39399,8084,0.01205614355694307,475,38924,False
2024-10-02 13:35:00,46054,8574,0.006058105702001998,279,45775,False
2024-10-02 13:40:00,46100,8827,0.004511930585683297,208,45892,False
2024-10-02 13:45:00,37474,8074,0.0100336233121631,376,37098,False
2024-10-02 13:50:00,46289,8836,0.00840372442696969,389,45900,False
2024-10-02 13:55:00,46699,8744,0.008287115355789203,387,46312,False
2024-10-02 14:00:00,47145,8799,0.01045710043482872,493,46652,False
2024-10-02 14:05:00,50261,8894,0.014245637770836235,716,49545,False
2024-10-02 14:10:00,34303,7653,0.010786228609742588,370,33933,False
2024-10-02 14:15:00,52011,9439,0.006556305396935263,341,51670,False
2024-10-02 14:20:00,60226,9670,0.004632550725600239,279,59947,False
2024-10-02 14:25:00,60319,9577,0.011837066264361146,714,59605,False
2024-10-02 14:30:00,54763,9964,0.004948596680240308,271,54492,False
2024-10-02 14:35:00,53303,9817,0.007185336660225503,383,52920,False
2024-10-02 14:40:00,46730,8784,0.011127755189385833,520,46210,False
2024-10-02 14:45:00,54058,9877,0.009156831551296755,495,53563,False
2024-10-02 14:50:00,51394,10084,0.004144452659843562,213,51181,False
2024-10-02 14:55:00,60981,10886,0.005067152063757564,309,60672,False
2024-10-02 15:00:00,57344,10191,0.008283342633928572,475,56869,False
2024-10-02 15:05:00,52079,9642,0.005683672881583748,296,51783,False
2024-10-02 15:10:00,74762,12963,0.0027687862818009147,207,74555,False
2024-10-02 15:15:00,58889,11365,0.00655470461376488,386,58503,False
2024-10-02 15:20:00,93589,12015,0.008911303678851148,834,92755,False
2024-10-02 15:25:00,92848,15259,0.006892986386351887,640,92208,False
2024-10-02 15:30:00,80637,14428,0.006771085233825663,546,80091,False
2024-10-02 15:35:00,82357,14093,0.008317447211530288,685,81672,False
2024-10-02 15:40:00,93193,13602,0.00678162522936272,632,92561,False
2024-10-02 15:45:00,80056,14084,0.005608573998201259,449,79607,False
2024-10-02 15:50:00,94371,14933,0.003253118012948893,307,94064,False
2024-10-02 15:55:00,137251,17698,0.0039489694064159826,542,136709,False
2024-10-02 16:00:00,95151,18885,0.006169141680066421,587,94564,False
2024-10-02 16:05:00,125321,19799,0.006279873285403085,787,124534,False
2024-10-02 16:10:00,100237,18933,0.004219998603310155,423,99814,False
2024-10-02 16:15:00,103962,19255,0.004790211808160674,498,103464,False
2024-10-02 16:20:00,76810,16360,0.006626741309725296,509,76301,False
2024-10-02 16:25:00,103352,19027,0.006618159300255438,684,102668,False
2024-10-02 16:30:00,108848,19400,0.007505879758929884,817,108031,False
2024-10-02 16:35:00,90051,17787,0.00822867042009528,741,89310,False
2024-10-02 16:40:00,93858,17313,0.00760723646359394,714,93144,False
2024-10-02 16:45:00,94656,17011,0.009486984448951994,898,93758,False
2024-10-02 16:50:00,79975,16108,0.009703032197561738,776,79199,False
2024-10-02 16:55:00,84043,15634,0.00829337363016551,697,83346,False
2024-10-02 17:00:00,158611,15622,0.006405608690443917,1016,157595,True
2024-10-02 17:05:00,83738,16825,0.0038214430724402304,320,83418,False
2024-10-02 17:10:00,109043,19697,0.00538319745421531,587,108456,False
2024-10-02 17:15:00,105684,19252,0.007664357897127285,810,104874,False
2024-10-02 17:20:00,102194,16710,0.005049220110769712,516,101678,False
2024-10-02 17:25:00,96879,17984,0.002074753042455021,201,96678,False
2024-10-02 17:30:00,67063,15120,0.0033848769067891388,227,66836,False
2024-10-02 17:35:00,226749,18593,0.00616981772797234,1399,225350,True
2024-10-02 17:40:00,137253,18091,0.005981654317209824,821,136432,False
2024-10-02 17:45:00,133758,18662,0.006152903003932475,823,132935,False
2024-10-02 17:50:00,80217,16400,0.003453133375718364,277,79940,False
2024-10-02 17:55:00,125554,21088,0.0028752568615894357,361,125193,False
2024-10-02 18:00:00,112358,20100,0.0038804535502589936,436,111922,False
2024-10-02 18:05:00,227910,31352,0.002917818437102365,665,227245,True
2024-10-02 18:10:00,286027,31961,0.002083719369150465,596,285431,True
2024-10-02 18:15:00,157322,25584,0.0019005606336049631,299,157023,True
2024-10-02 18:20:00,167879,23359,0.004884470362582574,820,167059,True
2024-10-02 18:25:00,149542,23492,0.004212863275868986,630,148912,True
2024-10-02 18:30:00,168937,23181,0.0008050338291789247,136,168801,True
2024-10-02 18:35:00,125087,21463,0.001023287791696979,128,124959,False
2024-10-02 18:40:00,176962,21346,0.0049558662311682735,877,176085,True
2024-10-02 18:45:00,332806,20539,0.005228271124919623,1740,331066,True
2024-10-02 18:50:00,160009,20262,0.006043410058184227,967,159042,True
2024-10-02 18:55:00,195568,19458,0.005547942403665221,1085,194483,True
2024-10-02 19:00:00,319680,20650,0.005668168168168168,1812,317868,True
2024-10-02 19:05:00,213001,21304,0.004835658048553763,1030,211971,True
2024-10-02 19:10:00,73705,15093,0.006254663862695882,461,73244,False
2024-10-02 19:15:00,144333,18782,0.007129346719045541,1029,143304,False
2024-10-02 19:20:00,106618,17344,0.006950045958468551,741,105877,False
2024-10-02 19:25:00,166090,16671,0.0028839785658377986,479,165611,True
2024-10-02 19:30:00,128702,15877,0.003923792948050535,505,128197,False
2024-10-02 19:35:00,102914,16843,0.005723225217171619,589,102325,False
2024-10-02 19:40:00,103878,15775,0.006411367180731243,666,103212,False
2024-10-02 19:45:00,93134,15175,0.007140249532931045,665,92469,False
2024-10-02 19:50:00,95711,15673,0.006665900471210206,638,95073,False
2024-10-02 19:55:00,76957,13783,0.008173395532570137,629,76328,False
2024-10-02 20:00:00,102167,13856,0.010649231160746621,1088,101079,False
2024-10-02 20:05:00,90732,8531,0.01146232861614425,1040,89692,False
2024-10-02 20:10:00,92018,13909,0.007770218870221043,715,91303,False
2024-10-02 20:15:00,55438,9603,0.007576030881344926,420,55018,False
2024-10-02 20:20:00,69494,9134,0.008633838892566265,600,68894,False
2024-10-02 20:25:00,142734,10646,0.0062213628147463115,888,141846,False
2024-10-02 20:30:00,93716,9990,0.007949549703359085,745,92971,False
2024-10-02 20:35:00,138734,9810,0.012145544711462222,1685,137049,False
2024-10-02 20:40:00,126563,9509,0.007403427542014649,937,125626,False
2024-10-02 20:45:00,52124,8231,0.005467730795794643,285,51839,False
2024-10-02 20:50:00,73253,8873,0.007071382742003741,518,72735,False
2024-10-02 20:55:00,69886,9252,0.00802735884154194,561,69325,False
2024-10-02 21:00:00,219384,9726,0.010657112642672209,2338,217046,True
2024-10-02 21:05:00,49017,7896,0.011281800191770202,553,48464,False
2024-10-02 21:10:00,101818,7134,0.010086625154687777,1027,100791,False
2024-10-02 21:15:00,117508,6419,0.00836538788848419,983,116525,False
2024-10-02 21:20:00,36076,5325,0.007705954096906531,278,35798,False
2024-10-02 21:35:00,11733,2328,0.008863888178641439,104,11629,False
2024-10-02 21:40:00,29968,4270,0.00800854244527496,240,29728,False
2024-10-02 21:45:00,30104,4166,0.013785543449375498,415,29689,False
2024-10-02 21:50:00,20815,3416,0.02161902474177276,450,20365,False
2024-10-02 21:55:00,26625,3719,0.028582159624413146,761,25864,False
2024-10-02 22:00:00,27184,3651,0.03347557386698058,910,26274,False
2024-10-02 22:05:00,1027,582,0.02629016553067186,27,1000,True
2024-10-02 22:15:00,8225,1617,0.028814589665653496,237,7988,False
2024-10-02 22:20:00,23767,3191,0.027853746791770103,662,23105,False
2024-10-02 22:25:00,22829,3065,0.03184545972228306,727,22102,False
2024-10-02 22:30:00,18907,2682,0.030940921351880257,585,18322,False
2024-10-02 22:45:00,20098,2662,0.03746641456861379,753,19345,False
2024-10-02 22:50:00,22215,2889,0.029304523970290344,651,21564,False
2024-10-02 22:55:00,21550,2816,0.027981438515081208,603,20947,False
2024-10-02 23:00:00,9865,1685,0.03395843892549417,335,9530,False
2024-10-02 23:10:00,14155,2174,0.027481455316142704,389,13766,False
2024-10-02 23:15:00,20563,2718,0.02548266303554929,524,20039,False
2024-10-02 23:20:00,20964,2812,0.02323029956115245,487,20477,False
2024-10-02 23:25:00,20113,2629,0.028687913289911996,577,19536,False
2024-10-02 23:45:00,16835,2345,0.01882981882981883,317,16518,False
2024-10-02 23:50:00,21709,2885,0.016629047860334423,361,21348,False
2024-10-02 23:55:00,22676,2961,0.02301993296877756,522,22154,False
2024-10-03 00:00:00,20700,2783,0.03434782608695652,711,19989,False
2024-10-03 00:25:00,4603,1172,0.029980447534216813,138,4465,False
2024-10-03 00:30:00,23858,3069,0.025023053063961773,597,23261,False
2024-10-03 00:35:00,24151,3205,0.026417125584861912,638,23513,False
2024-10-03 00:40:00,21116,2906,0.027183178632316726,574,20542,False
2024-10-03 00:45:00,21859,2935,0.022233405004803513,486,21373,False
2024-10-03 00:50:00,26335,3482,0.02164419973419404,570,25765,False
2024-10-03 00:55:00,27024,3531,0.020167258732978092,545,26479,False
2024-10-03 01:00:00,11832,2708,0.025524002704530088,302,11530,False
2024-10-03 01:05:00,30748,3855,0.023221022505528814,714,30034,False
2024-10-03 01:10:00,30578,3919,0.021387925959840407,654,29924,False
2024-10-03 01:15:00,15464,2567,0.020887221934816347,323,15141,False
2024-10-03 01:20:00,39145,4033,0.0206156597266573,807,38338,False
2024-10-03 01:25:00,65308,4216,0.02036503950511423,1330,63978,False
2024-10-03 01:30:00,59297,4245,0.022227094119432685,1318,57979,False
2024-10-03 01:35:00,33997,4304,0.01964879254051828,668,33329,False
2024-10-03 01:40:00,33346,4465,0.018113117015534096,604,32742,False
2024-10-03 01:45:00,36188,4681,0.013512766662982205,489,35699,False
2024-10-03 01:50:00,4886,1555,0.014121981170691772,69,4817,False
2024-10-03 01:55:00,9889,2191,0.01628071594701183,161,9728,False
2024-10-03 02:00:00,38321,5150,0.01529187651679236,586,37735,False
2024-10-03 02:05:00,46104,5173,0.018241367343397537,841,45263,False
2024-10-03 02:10:00,41128,5273,0.01748200739155806,719,40409,False
2024-10-03 02:15:00,41295,5391,0.021479598014287445,887,40408,False
2024-10-03 02:20:00,46993,5190,0.02015193752260975,947,46046,False
2024-10-03 02:25:00,97257,5579,0.019319946122130026,1879,95378,False
2024-10-03 02:30:00,94657,5744,0.013966214859968096,1322,93335,False
2024-10-03 02:35:00,51300,5030,0.014658869395711501,752,50548,False
2024-10-03 02:40:00,30406,4757,0.012760639347497205,388,30018,False
2024-10-03 02:45:00,44943,6115,0.015575284248937542,700,44243,False
2024-10-03 02:50:00,39542,6032,0.01259420363158161,498,39044,False
2024-10-03 02:55:00,48118,6496,0.013550022860468016,652,47466,False
2024-10-03 03:00:00,42890,6197,0.01359291210072278,583,42307,False
2024-10-03 03:05:00,44749,6894,0.014815973541308185,663,44086,False
2024-10-03 03:10:00,51851,7225,0.012516634201847602,649,51202,False
2024-10-03 03:15:00,44396,6975,0.015834759888278222,703,43693,False
2024-10-03 03:20:00,46321,6681,0.009002396321322942,417,45904,False
2024-10-03 03:25:00,52755,7516,0.012567529144156951,663,52092,False
2024-10-03 03:30:00,36770,6657,0.01096002175686701,403,36367,False
2024-10-03 03:35:00,53468,7588,0.007761651829131443,415,53053,False
2024-10-03 03:40:00,55857,7739,0.006140680666702473,343,55514,False
2024-10-03 03:45:00,45310,6829,0.006179651291105716,280,45030,False
2024-10-03 03:50:00,28556,5056,0.007494046785264043,214,28342,False
2024-10-03 03:55:00,45172,6997,0.006707695032320907,303,44869,False
2024-10-03 04:05:00,46571,7043,0.00949088488544373,442,46129,False
2024-10-03 04:10:00,35349,5881,0.01018416362556225,360,34989,False
2024-10-03 04:15:00,8864,2722,0.007671480144404332,68,8796,False
2024-10-03 04:20:00,99223,7966,0.007528496417161344,747,98476,False
2024-10-03 04:25:00,63382,7958,0.009845066422643652,624,62758,False
2024-10-03 04:30:00,15278,3553,0.011650739625605446,178,15100,False
2024-10-03 04:35:00,48613,7399,0.012218953777796063,594,48019,False
2024-10-03 04:40:00,25115,4912,0.00509655584312164,128,24987,False
2024-10-03 04:50:00,46200,7345,0.011558441558441558,534,45666,False
2024-10-03 04:55:00,50543,7874,0.014601428486635142,738,49805,False
2024-10-03 05:00:00,9753,2751,0.013124166922998053,128,9625,False
2024-10-03 05:05:00,21391,4367,0.010050956009536722,215,21176,False
2024-10-03 05:10:00,75147,7580,0.0017432498968688037,131,75016,False
2024-10-03 05:15:00,130661,7553,0.004507848554656707,589,130072,False
2024-10-03 05:20:00,128957,7720,0.010553905565421032,1361,127596,False
2024-10-03 05:25:00,86288,7538,0.014509549415909512,1252,85036,False
2024-10-03 05:30:00,8116,1930,0.0038196155741744703,31,8085,False
2024-10-03 05:35:00,34585,5092,0.003093826803527541,107,34478,False
2024-10-03 05:40:00,46908,7335,0.01332395327023109,625,46283,False
2024-10-03 05:45:00,44431,6890,0.008980216515495937,399,44032,False
2024-10-03 05:50:00,93810,7420,0.007696407632448566,722,93088,False
2024-10-03 05:55:00,50917,7380,0.011391087456055934,580,50337,False
2024-10-03 06:00:00,76427,6159,0.015897523126643727,1215,75212,False
2024-10-03 06:05:00,193212,6955,0.009409353456307062,1818,191394,True
2024-10-03 06:10:00,206165,7152,0.010481895569083017,2161,204004,True
2024-10-03 06:15:00,49169,6835,0.012304500803351706,605,48564,False
2024-10-03 06:20:00,43911,7101,0.014870989046024914,653,43258,False
2024-10-03 06:25:00,42423,7002,0.01685406501190392,715,41708,False
2024-10-03 06:30:00,40917,6809,0.0062810078940293765,257,40660,False
2024-10-03 06:35:00,21534,5007,0.0025076623014767345,54,21480,False
2024-10-03 06:40:00,42149,6641,0.017295784004365464,729,41420,False
2024-10-03 06:45:00,56712,6712,0.015746226548173228,893,55819,False
2024-10-03 06:50:00,40908,6681,0.010486946318568495,429,40479,False
2024-10-03 06:55:00,39223,6637,0.011319888840731204,444,38779,False
2024-10-03 07:00:00,37870,6421,0.013335093741748086,505,37365,False
2024-10-03 07:05:00,2949,1314,0.029840623940318754,88,2861,False
2024-10-03 07:15:00,33455,5683,0.015812285159169034,529,32926,False
2024-10-03 07:20:00,38054,6439,0.015057549797655962,573,37481,False
2024-10-03 07:25:00,47440,6334,0.022069983136593592,1047,46393,False
2024-10-03 07:30:00,38782,6269,0.02235573204063741,867,37915,False
2024-10-03 07:35:00,22493,4340,0.015204730360556617,342,22151,False
2024-10-03 07:40:00,36988,6198,0.014112685195198442,522,36466,False
2024-10-03 07:45:00,38302,6199,0.022949193253616,879,37423,False
2024-10-03 07:50:00,21726,4901,0.02117278836417196,460,21266,False
2024-10-03 07:55:00,38001,6193,0.02497302702560459,949,37052,False
2024-10-03 08:00:00,28823,5089,0.025639246435138603,739,28084,False
2024-10-03 08:05:00,13202,3152,0.01477048931980003,195,13007,False
2024-10-03 08:10:00,37260,6269,0.015458937198067632,576,36684,False
2024-10-03 08:15:00,37067,6245,0.01748185717754337,648,36419,False
2024-10-03 08:20:00,11855,2992,0.023450021088148462,278,11577,False
2024-10-03 08:25:00,36659,6211,0.019476799694481572,714,35945,False
2024-10-03 08:30:00,33406,5775,0.019337843501167455,646,32760,False
2024-10-03 08:35:00,62816,5529,0.01878502292409577,1180,61636,False
2024-10-03 08:40:00,76094,6327,0.023024154335427236,1752,74342,False
2024-10-03 08:45:00,58693,6285,0.019797931610243128,1162,57531,False
2024-10-03 08:50:00,73940,6226,0.01744657830673519,1290,72650,False
2024-10-03 08:55:00,60077,6348,0.017128019042229138,1029,59048,False
2024-10-03 09:00:00,34686,6104,0.016634953583578388,577,34109,False
2024-10-03 09:05:00,36188,6341,0.01837625732286946,665,35523,False
2024-10-03 09:10:00,11291,2863,0.01665042954565583,188,11103,False
2024-10-03 09:15:00,28523,5270,0.019598218981173088,559,27964,False
2024-10-03 09:20:00,36386,6359,0.020777222008464793,756,35630,False
2024-10-03 09:25:00,17011,3905,0.0169890071130445,289,16722,False
2024-10-03 09:40:00,20645,4225,0.01830951804310971,378,20267,False
2024-10-03 09:45:00,35569,6151,0.018555483707723017,660,34909,False
2024-10-03 09:50:00,36421,6205,0.014881524395266467,542,35879,False
2024-10-03 09:55:00,36361,6196,0.021094029317125493,767,35594,False
2024-10-03 10:00:00,34844,5965,0.021180117093330272,738,34106,False
2024-10-03 10:05:00,11800,2867,0.0211864406779661,250,11550,False
2024-10-03 10:10:00,35442,6025,0.022205293155013826,787,34655,False
2024-10-03 10:15:00,27661,5358,0.026607859441090342,736,26925,False
2024-10-03 10:20:00,35449,6074,0.02194702248300375,778,34671,False
2024-10-03 10:25:00,35545,6154,0.01716134477422985,610,34935,False
2024-10-03 10:30:00,1559,948,0.024374599101988453,38,1521,False
2024-10-03 10:40:00,21828,4325,0.014431006047278724,315,21513,False
2024-10-03 10:45:00,35563,6132,0.015071844332592864,536,35027,False
2024-10-03 10:50:00,24529,4773,0.014105752374740103,346,24183,False
2024-10-03 11:10:00,27704,5097,0.015051978053710656,417,27287,False
2024-10-03 11:15:00,34788,6127,0.014459008853627688,503,34285,False
2024-10-03 11:20:00,19428,4081,0.01101502985381923,214,19214,False
2024-10-03 11:25:00,25792,5028,0.015663771712158808,404,25388,False
2024-10-03 11:30:00,34590,6137,0.020005782017924256,692,33898,False
2024-10-03 11:35:00,35366,6155,0.013770287847084771,487,34879,False
2024-10-03 11:40:00,35529,6153,0.017084635086830478,607,34922,False
2024-10-03 11:45:00,32563,5904,0.014218591653103215,463,32100,False
2024-10-03 11:50:00,23116,3094,0.005277729711022668,122,22994,False
2024-10-03 11:55:00,89961,6183,0.008781583130467648,790,89171,False
2024-10-03 12:00:00,104379,6057,0.01621015721553186,1692,102687,False
2024-10-03 12:05:00,62406,6025,0.016857353459603243,1052,61354,False
2024-10-03 12:10:00,26080,5495,0.015145705521472392,395,25685,False
2024-10-03 12:15:00,34903,6210,0.014669226141019396,512,34391,False
2024-10-03 12:20:00,54212,6276,0.013889913672249687,753,53459,False
2024-10-03 12:25:00,35367,6202,0.014816071479062403,524,34843,False
2024-10-03 12:30:00,73330,6324,0.018232646938497205,1337,71993,False
2024-10-03 12:35:00,78334,6252,0.01729772512574361,1355,76979,False
2024-10-03 12:40:00,91574,6271,0.021294253827505622,1950,89624,False
2024-10-03 12:45:00,50375,6363,0.02854590570719603,1438,48937,False
2024-10-03 12:50:00,17179,3602,0.03643983933872751,626,16553,False
2024-10-03 12:55:00,15510,3589,0.022888459058671824,355,15155,False
2024-10-03 13:00:00,25412,4346,0.017275303006453645,439,24973,False
2024-10-03 13:05:00,75706,6619,0.02205901777930415,1670,74036,False
2024-10-03 13:10:00,110223,6520,0.020512960089999366,2261,107962,False
2024-10-03 13:15:00,65964,6632,0.02035959007943727,1343,64621,False
2024-10-03 13:20:00,90582,6646,0.01923119383541984,1742,88840,False
2024-10-03 13:25:00,65561,6749,0.020957581488994983,1374,64187,False
2024-10-03 13:30:00,65837,6875,0.020550754135212724,1353,64484,False
2024-10-03 13:35:00,55222,7082,0.019340118068885588,1068,54154,False
2024-10-03 13:40:00,32385,6615,0.024116103134167052,781,31604,False
2024-10-03 13:45:00,41374,7229,0.023565524242277758,975,40399,False
2024-10-03 13:50:00,31878,6499,0.02010791141225924,641,31237,False
2024-10-03 13:55:00,43432,7419,0.022402836618161726,973,42459,False
2024-10-03 14:00:00,40913,7145,0.020629139882189035,844,40069,False
2024-10-03 14:05:00,42307,7462,0.016592998794525728,702,41605,False
2024-10-03 14:10:00,15920,3783,0.016834170854271358,268,15652,False
2024-10-03 14:20:00,21148,4610,0.014138452808776243,299,20849,False
2024-10-03 14:25:00,43448,7564,0.018642975510955624,810,42638,False
2024-10-03 14:30:00,76218,7548,0.01801411740008922,1373,74845,False
2024-10-03 14:35:00,37151,7276,0.012193480660009151,453,36698,False
2024-10-03 14:40:00,45168,8021,0.009475735033652143,428,44740,False
2024-10-03 14:45:00,31983,6892,0.02038582997217272,652,31331,False
2024-10-03 14:50:00,67399,8333,0.016988382616952773,1145,66254,False
2024-10-03 14:55:00,83728,8580,0.014666539270017199,1228,82500,False
2024-10-03 15:00:00,74672,8383,0.00891900578530105,666,74006,False
2024-10-03 15:05:00,85733,8629,0.010754318640430173,922,84811,False
2024-10-03 15:10:00,47844,8500,0.012101830950589415,579,47265,False
2024-10-03 15:15:00,22359,4866,0.015430028176573192,345,22014,False
2024-10-03 15:25:00,96862,8615,0.008899258739237265,862,96000,False
2024-10-03 15:30:00,86162,9125,0.010874863628977972,937,85225,False
2024-10-03 15:35:00,44029,8341,0.013104998977946354,577,43452,False
2024-10-03 15:40:00,54963,9202,0.012735840474501029,700,54263,False
2024-10-03 15:45:00,78647,10117,0.01136724859180897,894,77753,False
2024-10-03 15:50:00,113744,10198,0.009635673090448727,1096,112648,False
2024-10-03 15:55:00,68631,9944,0.010141189841325348,696,67935,False
2024-10-03 16:00:00,96572,10516,0.010748457109721244,1038,95534,False
2024-10-03 16:05:00,72377,10422,0.010818353896956215,783,71594,False
2024-10-03 16:10:00,63759,10324,0.010006430464718706,638,63121,False
2024-10-03 16:15:00,31236,6969,0.009348187988218721,292,30944,False
2024-10-03 16:20:00,48447,8422,0.009639399756434868,467,47980,False
2024-10-03 16:25:00,62944,10266,0.009754702592780884,614,62330,False
2024-10-03 16:30:00,26965,6742,0.010754681995178936,290,26675,False
2024-10-03 16:35:00,55016,9224,0.012305511124036644,677,54339,False
2024-10-03 16:40:00,34520,6845,0.0019409038238702202,67,34453,False
2024-10-03 16:45:00,65948,10669,0.007627221447200825,503,65445,False
2024-10-03 16:50:00,52224,9109,0.008808210784313725,460,51764,False
2024-10-03 16:55:00,33608,6559,0.008807426803142109,296,33312,False
2024-10-03 17:00:00,124146,10388,0.010084900037053148,1252,122894,False
2024-10-03 17:05:00,88846,10213,0.008632915381671656,767,88079,False
2024-10-03 17:10:00,69158,10484,0.008589028022788398,594,68564,False
2024-10-03 17:15:00,45754,8850,0.010534598067928487,482,45272,False
2024-10-03 17:20:00,69224,10346,0.00977984514041373,677,68547,False
2024-10-03 17:25:00,68296,10348,0.010103080707508493,690,67606,False
2024-10-03 17:30:00,65898,10029,0.011532975204103312,760,65138,False
2024-10-03 17:35:00,68031,10303,0.009598565359909453,653,67378,False
2024-10-03 17:40:00,80336,10962,0.009783907588129855,786,79550,False
2024-10-03 17:45:00,85821,10781,0.010906421505225994,936,84885,False
2024-10-03 17:50:00,73900,10994,0.008876860622462788,656,73244,False
2024-10-03 17:55:00,96237,10411,0.01093134657148498,1052,95185,False
2024-10-03 18:00:00,65136,10202,0.014692336035372145,957,64179,False
2024-10-03 18:05:00,79366,11107,0.011919461734243882,946,78420,False
2024-10-03 18:10:00,115471,11470,0.007993348979397425,923,114548,False
2024-10-03 18:15:00,78278,11206,0.012366182069036,968,77310,False
2024-10-03 18:20:00,78058,11036,0.011606753952189398,906,77152,False
2024-10-03 18:25:00,68560,10186,0.01235414235705951,847,67713,False
2024-10-03 18:30:00,55942,8720,0.004039898466268636,226,55716,False
2024-10-03 18:35:00,82851,11507,0.005057271487368891,419,82432,False
2024-10-03 18:40:00,25047,5482,0.0015969976444284745,40,25007,False
2024-10-03 18:50:00,67445,10096,0.01014159685669805,684,66761,False
2024-10-03 18:55:00,93911,11939,0.007613591592039271,715,93196,False
2024-10-03 19:00:00,131072,11355,0.012176513671875,1596,129476,False
2024-10-03 19:05:00,62522,8620,0.00969258820895045,606,61916,False
2024-10-03 19:10:00,95304,9838,0.011489549231931503,1095,94209,False
2024-10-03 19:15:00,43640,7967,0.013611365719523373,594,43046,False
2024-10-03 19:20:00,56610,8546,0.01418477300830242,803,55807,False
2024-10-03 19:25:00,81248,8169,0.013120322961795983,1066,80182,False
2024-10-03 19:30:00,60004,8068,0.01384907672821812,831,59173,False
2024-10-03 19:35:00,36412,6709,0.015846424255739865,577,35835,False
2024-10-03 19:40:00,50214,7231,0.016031385669335246,805,49409,False
2024-10-03 19:45:00,55257,7219,0.012559494724650271,694,54563,False
2024-10-03 19:50:00,21625,4046,0.013410404624277457,290,21335,False
2024-10-03 19:55:00,31279,4740,0.016272898749960036,509,30770,False
2024-10-03 20:00:00,40983,6284,0.023887953541712418,979,40004,False
2024-10-03 20:05:00,48663,6217,0.02546082239072807,1239,47424,False
2024-10-03 20:10:00,108812,5997,0.016579053780832995,1804,107008,False
2024-10-03 20:15:00,42333,5763,0.018496208631564027,783,41550,False
2024-10-03 20:20:00,45586,5536,0.01805378844382047,823,44763,False
2024-10-03 20:25:00,37100,5546,0.018814016172506737,698,36402,False
2024-10-03 20:30:00,37937,5440,0.023143632865013048,878,37059,False
2024-10-03 20:35:00,51493,5099,0.025284990192841746,1302,50191,False
2024-10-03 20:40:00,44433,4965,0.015551504512411947,691,43742,False
2024-10-03 20:45:00,32609,4586,0.022294458585053207,727,31882,False
2024-10-03 20:50:00,18718,3029,0.024949246714392564,467,18251,False
2024-10-03 20:55:00,61624,4126,0.008616772685966506,531,61093,False
2024-10-03 21:00:00,27478,3927,0.025656889147681782,705,26773,False
2024-10-03 21:05:00,39835,4254,0.023898581649303377,952,38883,False
2024-10-03 21:10:00,27970,3787,0.02656417590275295,743,27227,False
2024-10-03 21:15:00,25743,3382,0.02163694985044478,557,25186,False
2024-10-03 21:20:00,21942,3083,0.027527116944672317,604,21338,False
2024-10-03 21:25:00,4906,1189,0.04178556869139829,205,4701,False
2024-10-03 21:40:00,3287,915,0.0383328262853666,126,3161,False
2024-10-03 21:45:00,18100,2449,0.041712707182320445,755,17345,False
2024-10-03 21:50:00,17358,2385,0.04384145638898491,761,16597,False
2024-10-03 21:55:00,16750,2277,0.04752238805970149,796,15954,False
2024-10-03 22:00:00,16033,2219,0.05993887606810953,961,15072,False
2024-10-03 22:05:00,10392,1639,0.059276366435719784,616,9776,False
2024-10-03 22:10:00,4194,934,0.03552694325226514,149,4045,False
2024-10-03 22:15:00,15674,2110,0.047594742886308536,746,14928,False
2024-10-03 22:20:00,14925,1956,0.0467001675041876,697,14228,False
2024-10-03 22:25:00,14862,1977,0.05456869869465752,811,14051,False
2024-10-03 22:30:00,16426,2056,0.07701205406063558,1265,15161,False
2024-10-03 22:35:00,13200,1736,0.07795454545454546,1029,12171,False
2024-10-03 23:05:00,603,304,0.14759535655058043,89,514,True
2024-10-03 23:10:00,13482,1888,0.044874647678386,605,12877,False
2024-10-03 23:15:00,12470,1770,0.04747393744987971,592,11878,False
2024-10-03 23:20:00,13378,1804,0.04320526237105696,578,12800,False
2024-10-03 23:25:00,13805,1866,0.05512495472654835,761,13044,False
2024-10-03 23:30:00,13461,1842,0.0421216848673947,567,12894,False
2024-10-03 23:35:00,6529,1111,0.0533006586000919,348,6181,False
2024-10-03 23:40:00,10909,1570,0.0596754972958108,651,10258,False
2024-10-03 23:45:00,37426,1861,0.04168225297921231,1560,35866,False
2024-10-03 23:50:00,42033,1810,0.050388980087074445,2118,39915,False
2024-10-03 23:55:00,42063,1842,0.042436345481777334,1785,40278,False
2024-10-04 00:00:00,49041,1950,0.10222059093411635,5013,44028,False
2024-10-04 00:05:00,52296,1995,0.12953189536484627,6774,45522,False
2024-10-04 00:10:00,43553,2077,0.0931967947098937,4059,39494,False
2024-10-04 00:15:00,26375,2056,0.05573459715639811,1470,24905,False
2024-10-04 00:20:00,15614,2036,0.0397719994876393,621,14993,False
2024-10-04 00:25:00,15632,1972,0.061668372569089046,964,14668,False
2024-10-04 00:30:00,17023,1979,0.10391822827938671,1769,15254,False
2024-10-04 00:35:00,22598,2047,0.052836534206566955,1194,21404,False
2024-10-04 00:40:00,31620,2077,0.03421884882985452,1082,30538,False
2024-10-04 00:45:00,18028,2109,0.04165742178832926,751,17277,False
2024-10-04 00:50:00,16454,2155,0.031117053603986873,512,15942,False
2024-10-04 00:55:00,17136,2193,0.038340336134453784,657,16479,False
2024-10-04 01:00:00,17797,2361,0.05927965387424847,1055,16742,False
2024-10-04 01:05:00,4812,1032,0.08603491271820449,414,4398,False
2024-10-04 01:15:00,3033,874,0.03297065611605671,100,2933,False
2024-10-04 01:20:00,18683,2520,0.03275705186533212,612,18071,False
2024-10-04 01:25:00,19484,2546,0.035311024430301784,688,18796,False
2024-10-04 01:30:00,20871,2614,0.062095730918499355,1296,19575,False
2024-10-04 01:35:00,20368,2652,0.04732914375490966,964,19404,False
2024-10-04 01:40:00,20677,2825,0.028969386274604634,599,20078,False
2024-10-04 01:45:00,1059,541,0.019830028328611898,21,1038,True
2024-10-04 01:50:00,9073,1673,0.022594511187038466,205,8868,False
2024-10-04 01:55:00,20954,2901,0.028395533072444402,595,20359,False
2024-10-04 02:00:00,22409,3049,0.027622830112901068,619,21790,False
2024-10-04 02:05:00,21292,2924,0.03879391320683825,826,20466,False
2024-10-04 02:10:00,1408,684,0.019886363636363636,28,1380,False
2024-10-04 02:15:00,23236,3239,0.02224995696333276,517,22719,False
2024-10-04 02:20:00,23882,3301,0.02478854367305921,592,23290,False
2024-10-04 02:25:00,38450,3304,0.01612483745123537,620,37830,False
2024-10-04 02:30:00,27157,3532,0.032330522517214716,878,26279,False
2024-10-04 02:35:00,24859,3502,0.013596685305120882,338,24521,False
2024-10-04 02:40:00,24848,3587,0.009698969735994848,241,24607,False
2024-10-04 02:45:00,16384,2718,0.02587890625,424,15960,False
2024-10-04 02:50:00,21663,3249,0.01707981350690117,370,21293,False
2024-10-04 02:55:00,27801,3859,0.018308693931872955,509,27292,False
2024-10-04 03:00:00,37913,4020,0.0386410993590589,1465,36448,False
2024-10-04 03:05:00,29212,4124,0.03365055456661646,983,28229,False
2024-10-04 03:10:00,31855,4551,0.030513263223983678,972,30883,False
2024-10-04 03:15:00,30053,4246,0.030279838951186237,910,29143,False
2024-10-04 03:20:00,30074,4343,0.01655915408658642,498,29576,False
2024-10-04 03:25:00,38796,4375,0.021522837405918135,835,37961,False
2024-10-04 03:30:00,32878,4523,0.028955532574974147,952,31926,False
2024-10-04 03:35:00,33204,4648,0.03222503312853873,1070,32134,False
2024-10-04 03:40:00,24399,4231,0.024673142341899258,602,23797,False
2024-10-04 03:45:00,32861,4770,0.02397979367639451,788,32073,False
2024-10-04 03:50:00,33340,4778,0.021745650869826036,725,32615,False
2024-10-04 03:55:00,5879,2307,0.028236094573907126,166,5713,False
2024-10-04 04:00:00,33261,4871,0.038152791557680164,1269,31992,False
2024-10-04 04:05:00,33399,4839,0.034791460822180306,1162,32237,False
2024-10-04 04:10:00,9835,2875,0.03457041179461108,340,9495,False
2024-10-04 04:15:00,49031,4830,0.02108869898635557,1034,47997,False
2024-10-04 04:20:00,41311,4615,0.0196315751252693,811,40500,False
2024-10-04 04:25:00,38393,4751,0.024353397754799052,935,37458,False
2024-10-04 04:30:00,25623,4406,0.0350076103500761,897,24726,False
2024-10-04 04:35:00,31585,4648,0.02453696374861485,775,30810,False
2024-10-04 04:40:00,31212,4770,0.023836985774702037,744,30468,False
2024-10-04 04:45:00,15751,2935,0.02355406005967875,371,15380,False
2024-10-04 04:50:00,32043,4717,0.027244640014979872,873,31170,False
2024-10-04 04:55:00,31240,4600,0.026920614596670934,841,30399,False
2024-10-04 05:00:00,18576,3350,0.028316106804478897,526,18050,False
2024-10-04 05:05:00,25056,4128,0.02713920817369093,680,24376,False
2024-10-04 05:10:00,29886,4729,0.026400321220638425,789,29097,False
2024-10-04 05:15:00,36374,4647,0.015313135756309451,557,35817,False
2024-10-04 05:20:00,30816,4681,0.019048546209761163,587,30229,False
2024-10-04 05:25:00,30598,4568,0.010588927380874568,324,30274,False
2024-10-04 05:30:00,19276,3887,0.004305872587673791,83,19193,False
2024-10-04 05:35:00,29081,4595,0.005536260788831196,161,28920,False
2024-10-04 05:40:00,31747,4746,0.004346867420543674,138,31609,False
2024-10-04 05:45:00,20006,3978,0.004848545436369089,97,19909,False
2024-10-04 05:50:00,28535,4652,0.0065533555282985805,187,28348,False
2024-10-04 05:55:00,28200,4610,0.00851063829787234,240,27960,False
2024-10-04 06:00:00,27072,4555,0.006353427895981087,172,26900,False
2024-10-04 06:05:00,27939,4517,0.03357314148681055,938,27001,False
2024-10-04 06:10:00,28626,4622,0.023579962272060363,675,27951,False
2024-10-04 06:15:00,27645,4595,0.008790016277807922,243,27402,False
2024-10-04 06:20:00,27219,4601,0.005400639259340902,147,27072,False
2024-10-04 06:25:00,25759,4395,0.006133778485189642,158,25601,False
2024-10-04 06:30:00,13003,2774,0.004537414442820888,59,12944,False
2024-10-04 06:35:00,27651,4617,0.014032042240786951,388,27263,False
2024-10-04 06:40:00,28237,4601,0.027552502036335306,778,27459,False
2024-10-04 06:45:00,13029,2753,0.025174610484304246,328,12701,False
2024-10-04 07:00:00,7043,1816,0.032940508306119554,232,6811,False
2024-10-04 07:05:00,32019,4536,0.030107123895187233,964,31055,False
2024-10-04 07:10:00,55342,4606,0.032850276462722705,1818,53524,False
2024-10-04 07:15:00,45403,4558,0.030856991828733783,1401,44002,False
2024-10-04 07:20:00,26918,4511,0.034623671892414,932,25986,False
2024-10-04 07:25:00,5307,1540,0.03843979649519502,204,5103,False
2024-10-04 07:35:00,27094,4483,0.03391894884476268,919,26175,False
2024-10-04 07:40:00,26189,4355,0.03291458245828401,862,25327,False
2024-10-04 07:45:00,26816,4449,0.03330101431980907,893,25923,False
2024-10-04 07:50:00,18575,3752,0.0317092866756393,589,17986,False
2024-10-04 07:55:00,26660,4456,0.032820705176294075,875,25785,False
2024-10-04 08:00:00,25458,4334,0.03825909340875167,974,24484,False
2024-10-04 08:05:00,13048,2504,0.03303188228080932,431,12617,False
2024-10-04 08:10:00,26082,4426,0.029829000843493596,778,25304,False
2024-10-04 08:15:00,25289,4505,0.0224208153742734,567,24722,False
2024-10-04 08:20:00,26025,4487,0.02881844380403458,750,25275,False
2024-10-04 08:25:00,32100,3849,0.03152647975077882,1012,31088,False
2024-10-04 08:30:00,54314,4584,0.03457672055087086,1878,52436,False
2024-10-04 08:35:00,53896,4502,0.04052248775419326,2184,51712,False
2024-10-04 08:40:00,49239,4464,0.036434533601413514,1794,47445,False
2024-10-04 08:45:00,26798,4609,0.030300768714083142,812,25986,False
2024-10-04 08:50:00,28630,4750,0.026510653161019908,759,27871,False
2024-10-04 08:55:00,27442,4646,0.028277822316157716,776,26666,False
2024-10-04 09:00:00,26212,4532,0.040019838242026554,1049,25163,False
2024-10-04 09:05:00,26966,4550,0.039123340502855444,1055,25911,False
2024-10-04 09:10:00,28062,4730,0.029684270543795882,833,27229,False
2024-10-04 09:15:00,29213,4909,0.02639235956594667,771,28442,False
2024-10-04 09:20:00,28436,4924,0.02588268392178928,736,27700,False
2024-10-04 09:25:00,27392,4723,0.030045268691588786,823,26569,False
2024-10-04 09:30:00,4252,1428,0.02916274694261524,124,4128,False
2024-10-04 09:35:00,29112,4956,0.0282014289640011,821,28291,False
2024-10-04 09:40:00,28053,4925,0.022564431611592342,633,27420,False
2024-10-04 09:45:00,29413,5034,0.020569136096283955,605,28808,False
2024-10-04 09:50:00,28972,4993,0.021365456302637028,619,28353,False
2024-10-04 09:55:00,27654,4679,0.023251609170463587,643,27011,False
2024-10-04 10:05:00,18336,3546,0.027595986038394416,506,17830,False
2024-10-04 10:10:00,30506,5181,0.027076640660853604,826,29680,False
2024-10-04 10:15:00,29270,5124,0.02494021182097711,730,28540,False
2024-10-04 10:20:00,32863,5035,0.025408514134436906,835,32028,False
2024-10-04 10:25:00,42924,5088,0.02525393719131488,1084,41840,False
2024-10-04 10:30:00,61026,5218,0.029364533149805,1792,59234,False
2024-10-04 10:35:00,43784,5263,0.03674858395761008,1609,42175,False
2024-10-04 10:40:00,7118,1996,0.024585557740938464,175,6943,False
2024-10-04 11:00:00,21881,4202,0.03176271651204241,695,21186,False
2024-10-04 11:05:00,59335,5545,0.026072301339850005,1547,57788,False
2024-10-04 11:10:00,59328,5587,0.01818702804746494,1079,58249,False
2024-10-04 11:15:00,30871,5561,0.01742735901007418,538,30333,False
2024-10-04 11:20:00,8809,2329,0.02213645135656715,195,8614,False
2024-10-04 11:25:00,22890,4417,0.017518567059851463,401,22489,False
2024-10-04 11:30:00,34108,5878,0.0316348070833822,1079,33029,False
2024-10-04 11:35:00,42230,5742,0.021619701633909544,913,41317,False
2024-10-04 11:40:00,49208,5781,0.013676637945049586,673,48535,False
2024-10-04 11:45:00,72165,5639,0.013732418762558027,991,71174,False
2024-10-04 11:50:00,96332,5873,0.014366980857866545,1384,94948,False
2024-10-04 11:55:00,12428,2510,0.01343739942066302,167,12261,False
2024-10-04 12:00:00,50952,6049,0.018350604490500865,935,50017,False
2024-10-04 12:05:00,35190,5333,0.019579425973287864,689,34501,False
2024-10-04 12:10:00,51561,6212,0.0139640425903299,720,50841,False
2024-10-04 12:15:00,13709,2540,0.014443066598584872,198,13511,False
2024-10-04 12:20:00,40421,5207,0.013606788550505925,550,39871,False
2024-10-04 12:25:00,52867,6422,0.01191669661603647,630,52237,False
2024-10-04 12:30:00,78280,6450,0.018893714869698517,1479,76801,False
2024-10-04 12:35:00,93682,6432,0.019608889647957987,1837,91845,False
2024-10-04 12:40:00,51609,6439,0.009068185781549729,468,51141,False
2024-10-04 12:45:00,35397,4889,0.01082012599937848,383,35014,False
2024-10-04 12:50:00,44248,5605,0.007977761706743807,353,43895,False
2024-10-04 12:55:00,37672,5040,0.010325971543852197,389,37283,False
2024-10-04 13:00:00,20932,3405,0.014857634244219377,311,20621,False
2024-10-04 13:05:00,52796,6421,0.018315781498598378,967,51829,False
2024-10-04 13:10:00,29156,4232,0.013822197832350117,403,28753,False
2024-10-04 13:15:00,44572,5599,0.013035089293727004,581,43991,False
2024-10-04 13:20:00,51801,6230,0.012470801721974479,646,51155,False
2024-10-04 13:25:00,46014,6054,0.010757595514408658,495,45519,False
2024-10-04 13:30:00,52205,6274,0.014998563356000383,783,51422,False
2024-10-04 13:35:00,33753,5237,0.014576482090480847,492,33261,False
2024-10-04 13:40:00,45603,5887,0.014823586167576695,676,44927,False
2024-10-04 13:55:00,21382,3906,0.019221775325039752,411,20971,False
2024-10-04 14:00:00,35846,6347,0.023768342353400657,852,34994,False
2024-10-04 14:05:00,24692,4862,0.02405637453426211,594,24098,False
2024-10-04 14:10:00,31695,5826,0.01662722826944313,527,31168,False
2024-10-04 14:15:00,48101,6626,0.016943514687844326,815,47286,False
2024-10-04 14:20:00,66424,6594,0.015370950258942551,1021,65403,False
2024-10-04 14:25:00,75632,6684,0.013935900148085467,1054,74578,False
2024-10-04 14:30:00,24499,3487,0.020776358218702804,509,23990,False
2024-10-04 14:35:00,37721,6671,0.017761989342806393,670,37051,False
2024-10-04 14:40:00,41204,6684,0.01089700029123386,449,40755,False
2024-10-04 14:45:00,43470,6703,0.013963653094087876,607,42863,False
2024-10-04 14:50:00,61597,6917,0.013588324106693507,837,60760,False
2024-10-04 14:55:00,57239,7104,0.013277660336483865,760,56479,False
2024-10-04 15:00:00,73519,6829,0.013574722180660782,998,72521,False
2024-10-04 15:05:00,31015,6124,0.01444462356924069,448,30567,False
2024-10-04 15:10:00,39013,7033,0.016097198369774177,628,38385,False
2024-10-04 15:15:00,40766,7276,0.017539125742039936,715,40051,False
2024-10-04 15:20:00,23696,5212,0.01759790681971641,417,23279,False
2024-10-04 15:25:00,40448,7211,0.014858583860759493,601,39847,False
2024-10-04 15:30:00,34271,6878,0.015552507951329113,533,33738,False
2024-10-04 15:35:00,42117,7335,0.017261438374053233,727,41390,False
2024-10-04 15:40:00,7921,2446,0.020199469763918697,160,7761,False
2024-10-04 15:45:00,19540,4260,0.013254861821903788,259,19281,False
2024-10-04 15:50:00,42329,7533,0.014434548418342035,611,41718,False
2024-10-04 15:55:00,34309,6890,0.013990498120026815,480,33829,False
2024-10-04 16:00:00,43286,7688,0.01374578385621217,595,42691,False
2024-10-04 16:05:00,24376,4989,0.014153265507056121,345,24031,False
2024-10-04 16:10:00,23045,4890,0.01297461488392276,299,22746,False
2024-10-04 16:15:00,69963,7749,0.01439332218458328,1007,68956,False
2024-10-04 16:20:00,64250,7881,0.012451361867704281,800,63450,False
2024-10-04 16:25:00,75147,8468,0.011417621461934608,858,74289,False
2024-10-04 16:30:00,26278,6428,0.014765202831265697,388,25890,False
2024-10-04 16:35:00,52321,9053,0.012327746029319011,645,51676,False
2024-10-04 16:40:00,8484,2721,0.013083451202263084,111,8373,False
2024-10-04 16:50:00,49986,7981,0.011163125675189053,558,49428,False
2024-10-04 16:55:00,85881,8653,0.010351532935107882,889,84992,False
2024-10-04 17:00:00,72810,8503,0.015149017992034062,1103,71707,False
2024-10-04 17:05:00,45275,8051,0.011750414135836555,532,44743,False
2024-10-04 17:10:00,35335,6652,0.007641149002405547,270,35065,False
2024-10-04 17:15:00,46585,8269,0.005624127938177525,262,46323,False
2024-10-04 17:20:00,81772,7809,0.0070562050579660515,577,81195,False
2024-10-04 17:25:00,80391,8511,0.009565747409535892,769,79622,False
2024-10-04 17:30:00,52882,8759,0.009398282969630498,497,52385,False
2024-10-04 17:35:00,39974,7379,0.0026517236203532297,106,39868,False
2024-10-04 17:40:00,26049,5332,0.015048562324849322,392,25657,False
2024-10-04 17:45:00,50977,8535,0.010671479294583832,544,50433,False
2024-10-04 17:50:00,42612,7939,0.013306110954660659,567,42045,False
2024-10-04 17:55:00,80333,8006,0.01268469993651426,1019,79314,False
2024-10-04 18:00:00,93748,8059,0.014933651917907582,1400,92348,False
2024-10-04 18:05:00,58603,8181,0.012507892087435796,733,57870,False
2024-10-04 18:10:00,49047,8263,0.01039818949171203,510,48537,False
2024-10-04 18:15:00,46248,7811,0.013103269330565647,606,45642,False
2024-10-04 18:20:00,53440,8646,0.01315494011976048,703,52737,False
2024-10-04 18:25:00,61030,9724,0.011109290512862526,678,60352,False
2024-10-04 18:30:00,56658,9096,0.012513678562603693,709,55949,False
2024-10-04 18:35:00,36866,7354,0.009710844680735638,358,36508,False
2024-10-04 18:40:00,48426,7995,0.007867674389790608,381,48045,False
2024-10-04 18:45:00,12127,3048,0.01673950688546219,203,11924,False
2024-10-04 18:50:00,46930,7599,0.015981248668229277,750,46180,False
2024-10-04 18:55:00,26829,5703,0.016959260501695925,455,26374,False
2024-10-04 19:00:00,57714,6762,0.019769899850989363,1141,56573,False
2024-10-04 19:05:00,59157,7085,0.01644775766181517,973,58184,False
2024-10-04 19:10:00,38777,6572,0.016891456275627305,655,38122,False
2024-10-04 19:15:00,554,452,0.016245487364620937,9,545,True
2024-10-04 19:20:00,37275,6284,0.022991281019450034,857,36418,False
2024-10-04 19:25:00,38025,6432,0.018408941485864562,700,37325,False
2024-10-04 19:30:00,39053,6435,0.020817862904258317,813,38240,False
2024-10-04 19:35:00,32549,5649,0.022304832713754646,726,31823,False
2024-10-04 19:40:00,33086,5775,0.018074109895424045,598,32488,False
2024-10-04 19:45:00,35410,6086,0.01669020050833098,591,34819,False
2024-10-04 19:50:00,12274,3347,0.0221606648199446,272,12002,False
2024-10-04 19:55:00,33151,5581,0.0173448764743145,575,32576,False
2024-10-04 20:00:00,31990,5468,0.02538293216630197,812,31178,False
2024-10-04 20:05:00,20994,4421,0.02705534914737544,568,20426,False
2024-10-04 20:10:00,34579,5160,0.02033025824922641,703,33876,False
2024-10-04 20:15:00,57220,5248,0.02245718280321566,1285,55935,False
2024-10-04 20:20:00,28146,4750,0.030164144105734383,849,27297,False
2024-10-04 20:25:00,28562,4909,0.024543099222743506,701,27861,False
2024-10-04 20:30:00,18232,3531,0.026491882404563405,483,17749,False
2024-10-04 20:40:00,84967,4287,0.011298504125130933,960,84007,False
2024-10-04 20:45:00,61384,4383,0.02222077414309918,1364,60020,False
2024-10-04 20:50:00,28985,4252,0.022459893048128343,651,28334,False
2024-10-04 20:55:00,23499,3903,0.026767096472190305,629,22870,False
2024-10-04 21:00:00,22374,3750,0.042236524537409496,945,21429,False
2024-10-04 21:05:00,21444,3402,0.03254989740720015,698,20746,False
2024-10-04 21:10:00,20571,3266,0.03237567449321861,666,19905,False
2024-10-04 21:15:00,19127,3014,0.03021906205886966,578,18549,False
2024-10-04 21:20:00,21942,2886,0.03140096618357488,689,21253,False
2024-10-04 21:25:00,22798,2762,0.031537854197736644,719,22079,False
2024-10-04 21:30:00,33326,2754,0.04035887895336974,1345,31981,False
2024-10-04 21:35:00,34702,2657,0.04293700651259293,1490,33212,False
2024-10-04 21:40:00,33254,2585,0.036506886389607265,1214,32040,False
2024-10-04 21:45:00,46005,2533,0.0330181502010651,1519,44486,False
2024-10-04 21:50:00,36064,2426,0.030002218278615794,1082,34982,False
2024-10-04 21:55:00,14770,2261,0.03683141503046716,544,14226,False
2024-10-04 22:00:00,14240,2231,0.05828651685393258,830,13410,False
2024-10-04 22:05:00,14075,2166,0.05492007104795737,773,13302,False
2024-10-04 22:10:00,13542,2135,0.04209127159946832,570,12972,False
2024-10-04 22:15:00,13458,2147,0.04866993609748848,655,12803,False
2024-10-04 22:20:00,13138,2033,0.05046430202466129,663,12475,False
2024-10-04 22:25:00,13192,1969,0.05905093996361431,779,12413,False
2024-10-04 22:30:00,13664,2009,0.05693793911007026,778,12886,False
2024-10-04 22:35:00,13337,1983,0.048361700532353606,645,12692,False
2024-10-04 22:40:00,12647,1940,0.05163279829208508,653,11994,False
2024-10-04 22:45:00,12226,1854,0.042941272697529856,525,11701,False
2024-10-04 22:50:00,8443,1384,0.06478739784436811,547,7896,False
2024-10-04 23:00:00,10451,1577,0.05205243517366759,544,9907,False
2024-10-04 23:05:00,12320,1792,0.04586038961038961,565,11755,False
2024-10-04 23:10:00,11886,1824,0.035756352010768974,425,11461,False
2024-10-04 23:15:00,11484,1766,0.04083942877046325,469,11015,False
2024-10-04 23:20:00,11659,1728,0.04828887554678789,563,11096,False
2024-10-04 23:25:00,11874,1740,0.035624052551793836,423,11451,False
2024-10-04 23:30:00,6121,1096,0.04492729946087241,275,5846,False
2024-10-05 00:25:00,9909,1583,0.03895448582097084,386,9523,False
2024-10-05 00:30:00,12472,1881,0.04674470814624759,583,11889,False
2024-10-05 00:35:00,12422,1838,0.040573176622122044,504,11918,False
2024-10-05 00:40:00,13114,1971,0.03431447308220223,450,12664,False
2024-10-05 00:45:00,13231,1973,0.037941198700022674,502,12729,False
2024-10-05 00:50:00,13619,2018,0.03451061017695866,470,13149,False
2024-10-05 00:55:00,7153,1321,0.03397176010065707,243,6910,False
2024-10-05 01:10:00,10872,1769,0.030997056659308315,337,10535,False
2024-10-05 01:15:00,5512,1153,0.03791727140783745,209,5303,False
2024-10-05 01:45:00,10672,1822,0.02633058470764618,281,10391,False
2024-10-05 01:50:00,17844,2601,0.02437794216543376,435,17409,False
2024-10-05 01:55:00,18725,2788,0.026969292389853138,505,18220,False
2024-10-05 02:00:00,18890,2850,0.03229221810481736,610,18280,False
2024-10-05 02:05:00,7597,1549,0.025799657759641964,196,7401,False
2024-10-05 02:30:00,22146,2986,0.026234986001986815,581,21565,False
2024-10-05 02:35:00,42150,3298,0.025005931198102016,1054,41096,False
2024-10-05 02:40:00,43182,3296,0.022324116530035663,964,42218,False
2024-10-05 02:45:00,44082,3319,0.021641486320947326,954,43128,False
2024-10-05 02:50:00,45642,3403,0.024275886245125104,1108,44534,False
2024-10-05 02:55:00,47572,3562,0.030227865130749182,1438,46134,False
2024-10-05 03:00:00,24117,3679,0.024132354770493844,582,23535,False
2024-10-05 03:05:00,16767,3178,0.024452794179042166,410,16357,False
2024-10-05 03:10:00,24497,3924,0.02588072008817406,634,23863,False
2024-10-05 03:15:00,24784,3824,0.021021626856036153,521,24263,False
2024-10-05 03:20:00,24624,4019,0.017828135152696555,439,24185,False
2024-10-05 03:25:00,27375,4311,0.017095890410958905,468,26907,False
2024-10-05 03:30:00,27706,4229,0.022305637767992492,618,27088,False
2024-10-05 03:35:00,10550,2421,0.02056872037914692,217,10333,False
2024-10-05 03:40:00,27253,4351,0.01570469306131435,428,26825,False
2024-10-05 03:45:00,27494,4461,0.0168764093984142,464,27030,False
2024-10-05 03:50:00,26878,4276,0.018490959148746187,497,26381,False
2024-10-05 03:55:00,5371,1573,0.015267175572519083,82,5289,False
2024-10-05 04:00:00,28439,4516,0.020218713738176446,575,27864,False
2024-10-05 04:05:00,28787,4656,0.01927953590162226,555,28232,False
2024-10-05 04:10:00,30257,4933,0.019400469312886276,587,29670,False
2024-10-05 04:15:00,30864,4830,0.014709694142042509,454,30410,False
2024-10-05 04:20:00,30971,4856,0.014884892318620646,461,30510,False
2024-10-05 04:25:00,31224,4922,0.016974122469894954,530,30694,False
2024-10-05 04:30:00,32245,5044,0.020065126376182355,647,31598,False
2024-10-05 04:35:00,32221,5113,0.014524688867508767,468,31753,False
2024-10-05 04:40:00,31755,5134,0.008754526846165959,278,31477,False
2024-10-05 04:45:00,31567,5222,0.014667215763297114,463,31104,False
2024-10-05 04:50:00,24335,4662,0.018656256420793098,454,23881,False
2024-10-05 04:55:00,33127,5335,0.015848099737374347,525,32602,False
2024-10-05 05:00:00,31781,5243,0.020295144897894968,645,31136,False
2024-10-05 05:05:00,24447,4774,0.018407166523499816,450,23997,False
2024-10-05 05:10:00,32837,5286,0.014282668940524408,469,32368,False
2024-10-05 05:15:00,31292,5270,0.021059695768886617,659,30633,False
2024-10-05 05:20:00,11273,2587,0.013749667346757739,155,11118,False
2024-10-05 05:25:00,33932,5693,0.015236355063067312,517,33415,False
2024-10-05 05:30:00,33944,5672,0.01705750648126326,579,33365,False
2024-10-05 05:35:00,34747,5606,0.01922468126744755,668,34079,False
2024-10-05 05:40:00,26198,4890,0.012863577372318498,337,25861,False
2024-10-05 05:45:00,34212,5763,0.008739623523909739,299,33913,False
2024-10-05 05:50:00,35087,5788,0.014506797389346482,509,34578,False
2024-10-05 05:55:00,26697,5230,0.01393414990448365,372,26325,False
2024-10-05 06:00:00,35239,5979,0.013678027185788474,482,34757,False
2024-10-05 06:05:00,16818,3508,0.017481270067784518,294,16524,False
2024-10-05 06:10:00,23705,4625,0.011938409618224004,283,23422,False
2024-10-05 06:15:00,36760,6144,0.012241566920565832,450,36310,False
2024-10-05 06:20:00,34882,5987,0.01097987500716702,383,34499,False
2024-10-05 06:25:00,19491,4416,0.011902929557231543,232,19259,False
2024-10-05 06:30:00,36466,6174,0.01187407448033785,433,36033,False
2024-10-05 06:35:00,28165,5046,0.0037280312444523344,105,28060,False
2024-10-05 06:40:00,26008,4792,0.014764687788372808,384,25624,False
2024-10-05 06:45:00,43512,6400,0.010250045964331678,446,43066,False
2024-10-05 06:50:00,12400,3031,0.012983870967741935,161,12239,False
2024-10-05 06:55:00,61676,5664,0.01053894545690382,650,61026,False
2024-10-05 07:00:00,75146,6501,0.01293482021664493,972,74174,False
2024-10-05 07:05:00,34515,5849,0.010604085180356366,366,34149,False
2024-10-05 07:10:00,38070,6499,0.015077488836354085,574,37496,False
2024-10-05 07:15:00,28161,5307,0.015340364333652923,432,27729,False
2024-10-05 07:25:00,34367,6185,0.012628393517036693,434,33933,False
2024-10-05 07:30:00,59937,6581,0.020688389475616062,1240,58697,False
2024-10-05 07:35:00,59000,6477,0.0181864406779661,1073,57927,False
2024-10-05 07:40:00,73202,6547,0.012868500860632223,942,72260,False
2024-10-05 07:45:00,39850,6612,0.0164366373902133,655,39195,False
2024-10-05 07:50:00,53756,5701,0.01590520127985713,855,52901,False
2024-10-05 07:55:00,72692,6760,0.015517526000110053,1128,71564,False
2024-10-05 08:00:00,41825,6162,0.02199641362821279,920,40905,False
2024-10-05 08:05:00,11140,2914,0.021364452423698384,238,10902,False
2024-10-05 08:10:00,38248,6905,0.013621627274628739,521,37727,False
2024-10-05 08:15:00,38495,7040,0.014495389011559943,558,37937,False
2024-10-05 08:20:00,16445,4540,0.01629674673152934,268,16177,False
2024-10-05 08:25:00,37442,6709,0.016238448800811923,608,36834,False
2024-10-05 08:30:00,54686,6825,0.02887393482792671,1579,53107,False
2024-10-05 08:35:00,38473,7033,0.0226912380110727,873,37600,False
2024-10-05 08:40:00,38183,6978,0.01710185160935495,653,37530,False
2024-10-05 08:45:00,46374,6957,0.01231293397162203,571,45803,False
2024-10-05 08:50:00,38439,7045,0.011680844975155442,449,37990,False
2024-10-05 08:55:00,33800,6626,0.011627218934911242,393,33407,False
2024-10-05 09:00:00,41799,7405,0.0258857867413096,1082,40717,False
2024-10-05 09:05:00,41109,7377,0.025687805590016783,1056,40053,False
2024-10-05 09:10:00,39779,7311,0.013399029638754117,533,39246,False
2024-10-05 09:15:00,24516,5903,0.01705008973731441,418,24098,False
2024-10-05 09:20:00,40619,7611,0.01341736625717029,545,40074,False
2024-10-05 09:25:00,31416,6782,0.012509549274255157,393,31023,False
2024-10-05 09:30:00,41089,7415,0.01623305507556767,667,40422,False
2024-10-05 09:35:00,25479,5390,0.008791553828643196,224,25255,False
2024-10-05 09:40:00,41849,7636,0.015340868360056393,642,41207,False
2024-10-05 09:45:00,40071,7415,0.014099972548726011,565,39506,False
2024-10-05 09:50:00,58834,7601,0.012832715776591766,755,58079,False
2024-10-05 09:55:00,82436,8238,0.010517249745256927,867,81569,False
2024-10-05 10:00:00,56700,8236,0.012239858906525573,694,56006,False
2024-10-05 10:05:00,36889,7739,0.01320176746455583,487,36402,False
2024-10-05 10:10:00,46879,8601,0.009023230017705155,423,46456,False
2024-10-05 10:15:00,29607,7063,0.011990407673860911,355,29252,False
2024-10-05 10:20:00,54481,8669,0.010242102751417926,558,53923,False
2024-10-05 10:25:00,32259,6189,0.008803744691403948,284,31975,False
2024-10-05 10:30:00,48683,8936,0.011893268697491938,579,48104,False
2024-10-05 10:35:00,49460,8924,0.01447634452082491,716,48744,False
2024-10-05 10:40:00,42288,8670,0.008654937570942111,366,41922,False
2024-10-05 10:45:00,51640,9374,0.0087141750580945,450,51190,False
2024-10-05 10:50:00,54872,9918,0.00730791660591923,401,54471,False
2024-10-05 10:55:00,96979,10505,0.009940296352818652,964,96015,False
2024-10-05 11:00:00,72412,10327,0.009197370601557753,666,71746,False
2024-10-05 11:05:00,74429,10603,0.007295543403780785,543,73886,False
2024-10-05 11:10:00,185234,10791,0.005592925704784219,1036,184198,True
2024-10-05 11:15:00,186056,10620,0.0076804832953519375,1429,184627,True
2024-10-05 11:20:00,93104,10684,0.008946984017872486,833,92271,False
2024-10-05 11:25:00,55979,10598,0.0076814519730613266,430,55549,False
2024-10-05 11:30:00,63251,10808,0.010450427661222747,661,62590,False
2024-10-05 11:35:00,81505,10995,0.00825716213729219,673,80832,False
2024-10-05 11:40:00,82260,11161,0.006564551422319475,540,81720,False
2024-10-05 11:45:00,136074,12116,0.008554169055072974,1164,134910,False
2024-10-05 11:50:00,134728,11343,0.006850840211388872,923,133805,False
2024-10-05 11:55:00,71268,12392,0.006650951338609193,474,70794,False
2024-10-05 12:00:00,17381,4739,0.008227374719521317,143,17238,False
2024-10-05 12:10:00,25746,6135,0.004777441155907714,123,25623,False
2024-10-05 12:15:00,42872,9684,0.009679977607762642,415,42457,False
2024-10-05 12:20:00,75073,12910,0.00745940617798676,560,74513,False
2024-10-05 12:25:00,44725,8734,0.005053102291783119,226,44499,False
2024-10-05 12:30:00,113232,13822,0.0076833403984739295,870,112362,False
2024-10-05 12:35:00,104455,14924,0.007084390407352448,740,103715,False
2024-10-05 12:40:00,142761,14816,0.006458346467172407,922,141839,False
2024-10-05 12:45:00,63941,12054,0.007100295584992415,454,63487,False
2024-10-05 12:50:00,56477,12642,0.005205658940807763,294,56183,False
2024-10-05 12:55:00,103554,17873,0.0046159491666183826,478,103076,False
2024-10-05 13:00:00,109815,19505,0.005636752720484451,619,109196,False
2024-10-05 13:05:00,159466,18428,0.005411811922290645,863,158603,False
2024-10-05 13:10:00,121065,18181,0.005534217156073184,670,120395,False
2024-10-05 13:15:00,158977,17394,0.007479069299332608,1189,157788,False
2024-10-05 13:20:00,163236,18158,0.005930064446568159,968,162268,True
2024-10-05 13:25:00,183913,20342,0.0059919635914807545,1102,182811,True
2024-10-05 13:30:00,258693,20204,0.005253331168605258,1359,257334,True
2024-10-05 13:35:00,175094,18280,0.0057055067563708635,999,174095,True
2024-10-05 13:40:00,206640,16573,0.005478126209833527,1132,205508,True
2024-10-05 13:45:00,213596,19756,0.005997303320286897,1281,212315,True
2024-10-05 13:50:00,223104,20153,0.005284530981067126,1179,221925,True
2024-10-05 13:55:00,124674,20480,0.005285785328135778,659,124015,False
2024-10-05 14:00:00,123249,20479,0.005444263239458332,671,122578,False
2024-10-05 14:05:00,156976,20550,0.005319284476607889,835,156141,False
2024-10-05 14:10:00,105455,19495,0.00487411692190982,514,104941,False
2024-10-05 14:15:00,104036,19560,0.006026759967703487,627,103409,False
2024-10-05 14:20:00,128094,21329,0.004785548113104439,613,127481,False
2024-10-05 14:25:00,119374,20101,0.00516025265133111,616,118758,False
2024-10-05 14:30:00,123322,20583,0.004670699469680998,576,122746,False
2024-10-05 14:35:00,89886,17841,0.005195469817324166,467,89419,False
2024-10-05 14:40:00,173690,21374,0.005457999884852323,948,172742,True
2024-10-05 14:45:00,133585,21624,0.0047235842347568965,631,132954,False
2024-10-05 14:50:00,130127,20988,0.0029740176904101377,387,129740,False
2024-10-05 14:55:00,83340,17826,0.0039116870650347975,326,83014,False
2024-10-05 15:00:00,145968,23158,0.004775019182286529,697,145271,True
2024-10-05 15:05:00,128214,21060,0.004804467530846865,616,127598,False
2024-10-05 15:10:00,525976,23430,0.0045534397006707535,2395,523581,True
2024-10-05 15:15:00,77476,15689,0.004052867984924363,314,77162,False
2024-10-05 15:20:00,121361,18450,0.003625546921993062,440,120921,False
2024-10-05 15:25:00,234411,25475,0.0031355183843761597,735,233676,True
2024-10-05 15:30:00,150019,24306,0.003259587118964931,489,149530,True
2024-10-05 15:35:00,184812,23487,0.004642555678202714,858,183954,True
2024-10-05 15:40:00,213558,20366,0.0035353393457515053,755,212803,True
2024-10-05 15:45:00,93227,17751,0.00401171334484645,374,92853,False
2024-10-05 15:50:00,150709,25075,0.003967911670835849,598,150111,True
2024-10-05 15:55:00,300040,28581,0.003672843620850553,1102,298938,True
2024-10-05 16:00:00,268805,28876,0.0039024571715555885,1049,267756,True
2024-10-05 16:05:00,16601,6571,0.003252816095415939,54,16547,False
2024-10-05 16:10:00,17456,6840,0.0036090742438130157,63,17393,False
2024-10-05 16:15:00,170885,24994,0.003704245545249729,633,170252,True
2024-10-05 16:20:00,142948,17102,0.004057419481209951,580,142368,False
2024-10-05 16:25:00,65536,14114,0.00384521484375,252,65284,False
2024-10-05 16:30:00,277999,23675,0.005330954427893626,1482,276517,True
2024-10-05 16:35:00,201664,24164,0.0035950888606791497,725,200939,True
2024-10-05 16:40:00,171190,24871,0.001185816928558911,203,170987,True
2024-10-05 16:45:00,184202,21846,0.0016069315208303927,296,183906,True
2024-10-05 16:50:00,153196,24212,0.003772944463301914,578,152618,True
2024-10-05 16:55:00,225110,25298,0.003242859046688286,730,224380,True
2024-10-05 17:00:00,209289,21503,0.00504565457334117,1056,208233,True
2024-10-05 17:05:00,207850,24903,0.004777483762328602,993,206857,True
2024-10-05 17:10:00,83901,18187,0.004302690075207685,361,83540,False
2024-10-05 17:15:00,188369,23589,0.004268218231237624,804,187565,True
2024-10-05 17:20:00,162276,21694,0.005398210456259706,876,161400,True
2024-10-05 17:25:00,116316,21646,0.0048402627325561404,563,115753,False
2024-10-05 17:30:00,114361,20932,0.005272776558442127,603,113758,False
2024-10-05 17:35:00,112866,18881,0.004961635922244077,560,112306,False
2024-10-05 17:40:00,149278,21082,0.004066238829566312,607,148671,False
2024-10-05 17:45:00,220053,21443,0.004630702603463711,1019,219034,True
2024-10-05 17:50:00,155995,20843,0.004968107952177955,775,155220,False
2024-10-05 17:55:00,186180,16306,0.0041196691373939194,767,185413,True
2024-10-05 18:00:00,113571,21021,0.004569828565390813,519,113052,False
2024-10-05 18:05:00,256749,23517,0.004701089390805806,1207,255542,True
2024-10-05 18:10:00,238275,22070,0.005065575490504669,1207,237068,True
2024-10-05 18:15:00,149186,16017,0.006240531953400453,931,148255,False
2024-10-05 18:20:00,101594,17186,0.006693308659960234,680,100914,False
2024-10-05 18:25:00,86658,16179,0.005515936209005516,478,86180,False
2024-10-05 18:30:00,81920,14576,0.005322265625,436,81484,False
2024-10-05 18:35:00,98630,16939,0.0046132008516678496,455,98175,False
2024-10-05 18:40:00,109266,17835,0.003166584298866985,346,108920,False
2024-10-05 18:45:00,38451,11104,0.005019375308834621,193,38258,False
2024-10-05 18:50:00,64949,12513,0.005727570863292737,372,64577,False
2024-10-05 18:55:00,147216,21114,0.004979078361047712,733,146483,False
2024-10-05 19:00:00,185285,22882,0.0056291658795909,1043,184242,True
2024-10-05 19:05:00,91077,17496,0.006686649757897164,609,90468,False
2024-10-05 19:10:00,79061,14226,0.005072032987187109,401,78660,False
2024-10-05 19:15:00,88414,16469,0.006503494921618748,575,87839,False
2024-10-05 19:20:00,138298,17622,0.006919839766301754,957,137341,False
2024-10-05 19:25:00,161064,15818,0.007257984403715293,1169,159895,True
2024-10-05 19:30:00,214737,15633,0.00954190474859945,2049,212688,True
2024-10-05 19:35:00,69551,13115,0.008037267616569137,559,68992,False
2024-10-05 19:40:00,86347,13925,0.0059064009172293186,510,85837,False
2024-10-05 19:45:00,58125,10350,0.007690322580645162,447,57678,False
2024-10-05 19:50:00,39507,7895,0.004480218695421065,177,39330,False
2024-10-05 19:55:00,55177,10972,0.008445547963825507,466,54711,False
2024-10-05 20:00:00,76108,12199,0.012311452146949073,937,75171,False
2024-10-05 20:05:00,125312,12160,0.010118743615934627,1268,124044,False
2024-10-05 20:10:00,97920,12205,0.009334150326797385,914,97006,False
2024-10-05 20:15:00,31900,8120,0.009435736677115987,301,31599,False
2024-10-05 20:20:00,64529,10696,0.007562491282989044,488,64041,False
2024-10-05 20:25:00,369,339,0.016260162601626018,6,363,True
2024-10-05 20:30:00,122208,10680,0.01576819848127782,1927,120281,False
2024-10-05 20:35:00,88771,10423,0.015466762794155748,1373,87398,False
2024-10-05 20:40:00,51682,9754,0.010912890368019814,564,51118,False
2024-10-05 20:45:00,62157,10021,0.010618273082677735,660,61497,False
2024-10-05 20:50:00,54159,9030,0.011152347716907623,604,53555,False
2024-10-05 20:55:00,42480,7460,0.004496233521657251,191,42289,False
2024-10-05 21:00:00,58284,9286,0.0169514789650676,988,57296,False
2024-10-05 21:05:00,51538,8423,0.017365827156661105,895,50643,False
2024-10-05 21:10:00,48462,7830,0.015393504188848994,746,47716,False
2024-10-05 21:15:00,71802,7560,0.012269853207431548,881,70921,False
2024-10-05 21:20:00,88888,7220,0.013680136801368014,1216,87672,False
2024-10-05 21:25:00,78096,6815,0.015391313255480434,1202,76894,False
2024-10-05 21:30:00,40150,6539,0.026625155666251555,1069,39081,False
2024-10-05 21:35:00,5516,1873,0.024474256707759247,135,5381,False
2024-10-05 21:45:00,3454,1395,0.018529241459177764,64,3390,False
2024-10-05 21:50:00,34176,5883,0.01293305243445693,442,33734,False
2024-10-05 21:55:00,33355,5788,0.01975715784739919,659,32696,False
2024-10-05 22:00:00,34966,5639,0.03177372304524395,1111,33855,False
2024-10-05 22:05:00,53244,5503,0.03239801667793554,1725,51519,False
2024-10-05 22:10:00,65588,5402,0.02335793132890163,1532,64056,False
2024-10-05 22:15:00,40946,5556,0.01692473013236946,693,40253,False
2024-10-05 22:20:00,63150,5422,0.014030087094220111,886,62264,False
2024-10-05 22:25:00,31548,5178,0.01692658805629517,534,31014,False
2024-10-05 22:30:00,11280,2495,0.03226950354609929,364,10916,False
2024-10-05 22:35:00,9997,2293,0.03260978293488046,326,9671,False
2024-10-05 22:40:00,30229,4900,0.024049753547917562,727,29502,False
2024-10-05 22:45:00,29805,4834,0.02486160040261701,741,29064,False
2024-10-05 22:50:00,11889,2615,0.023971738581882413,285,11604,False
2024-10-05 22:55:00,12569,2609,0.024743416341793303,311,12258,False
2024-10-05 23:00:00,32193,4526,0.03929425651539154,1265,30928,False
2024-10-05 23:05:00,75580,4485,0.03754961630060863,2838,72742,False
2024-10-05 23:10:00,55094,4401,0.020401495625657965,1124,53970,False
2024-10-05 23:15:00,52763,4256,0.021416522942213294,1130,51633,False
2024-10-05 23:20:00,27747,4436,0.021263560024507154,590,27157,False
2024-10-05 23:25:00,27416,4265,0.02451123431572804,672,26744,False
2024-10-05 23:30:00,27717,4406,0.026229389905112387,727,26990,False
2024-10-05 23:35:00,27539,4425,0.0166672718689858,459,27080,False
2024-10-05 23:40:00,27034,4314,0.018791151882814234,508,26526,False
2024-10-05 23:45:00,26798,4347,0.024554071199343233,658,26140,False
2024-10-05 23:50:00,13480,2715,0.023590504451038576,318,13162,False
2024-10-05 23:55:00,9488,2207,0.021500843170320406,204,9284,False
2024-10-06 00:00:00,28721,4616,0.02165662755475088,622,28099,False
2024-10-06 00:05:00,30122,4790,0.025927893234180998,781,29341,False
2024-10-06 00:10:00,30122,4829,0.020051789389814754,604,29518,False
2024-10-06 00:15:00,31643,5019,0.025850899093006353,818,30825,False
2024-10-06 00:20:00,31850,4974,0.020816326530612245,663,31187,False
2024-10-06 00:25:00,31502,4987,0.020093962288108693,633,30869,False
2024-10-06 00:30:00,32049,5090,0.014852257480732628,476,31573,False
2024-10-06 00:35:00,31536,5076,0.0121765601217656,384,31152,False
2024-10-06 00:40:00,32424,5146,0.01495805576116457,485,31939,False
2024-10-06 00:45:00,31327,5056,0.015769144827145913,494,30833,False
2024-10-06 01:05:00,22805,4259,0.013593510195132646,310,22495,False
2024-10-06 01:10:00,36998,5944,0.014135899237796637,523,36475,False
2024-10-06 01:15:00,22117,4187,0.014378080209793372,318,21799,False
2024-10-06 01:20:00,3340,1473,0.010179640718562874,34,3306,False
2024-10-06 01:25:00,39052,6238,0.013494827409607703,527,38525,False
2024-10-06 01:30:00,39893,6378,0.014714360915448825,587,39306,False
2024-10-06 01:35:00,41468,6716,0.013721423748432526,569,40899,False
2024-10-06 01:40:00,23703,4663,0.0117284731890478,278,23425,False
2024-10-06 01:45:00,34011,5961,0.014818735115109817,504,33507,False
2024-10-06 01:50:00,43056,7102,0.005132850241545894,221,42835,False
2024-10-06 01:55:00,46020,7676,0.008626684050412864,397,45623,False
2024-10-06 02:00:00,35847,7444,0.01333444918682177,478,35369,False
2024-10-06 02:05:00,51761,8857,0.00940862811769479,487,51274,False
2024-10-06 02:10:00,101281,8931,0.008718318342038487,883,100398,False
2024-10-06 02:15:00,93924,8810,0.01453302670244027,1365,92559,False
2024-10-06 02:20:00,26032,6625,0.010563921327596804,275,25757,False
2024-10-06 02:25:00,83145,9050,0.012267725058632509,1020,82125,False
2024-10-06 02:30:00,65910,9033,0.008708845395235927,574,65336,False
2024-10-06 02:35:00,8152,2781,0.009690873405299312,79,8073,False
2024-10-06 02:40:00,20232,4900,0.009440490312376433,191,20041,False
2024-10-06 02:45:00,56001,9954,0.009392689416260425,526,55475,False
2024-10-06 02:50:00,40629,8169,0.00826995495828103,336,40293,False
2024-10-06 02:55:00,51038,10142,0.009972961322935852,509,50529,False
2024-10-06 03:00:00,62851,11160,0.009705493945999268,610,62241,False
2024-10-06 03:05:00,41370,9029,0.006550640560792845,271,41099,False
2024-10-06 03:10:00,33488,7478,0.007614667940754897,255,33233,False
2024-10-06 03:15:00,44935,9125,0.005919661733615222,266,44669,False
2024-10-06 03:20:00,68977,12562,0.00655290894066138,452,68525,False
2024-10-06 03:25:00,60628,11952,0.007471795210133932,453,60175,False
2024-10-06 03:30:00,71220,12959,0.008185902836281943,583,70637,False
2024-10-06 03:35:00,68774,12493,0.005190915171431064,357,68417,False
2024-10-06 03:40:00,15880,6241,0.005730478589420655,91,15789,False
2024-10-06 03:45:00,76968,14027,0.0047422305373661785,365,76603,False
2024-10-06 03:50:00,44963,9910,0.005382203144807953,242,44721,False
2024-10-06 03:55:00,118157,13651,0.00580583460988346,686,117471,False
2024-10-06 04:00:00,268231,15641,0.004809287517102796,1290,266941,True
2024-10-06 04:05:00,77772,15443,0.0057990022115928614,451,77321,False
2024-10-06 04:10:00,40145,9427,0.006127786772948063,246,39899,False
2024-10-06 04:15:00,16790,5453,0.006730196545562835,113,16677,False
2024-10-06 04:20:00,128087,16285,0.006253562032056337,801,127286,False
2024-10-06 04:25:00,114362,14045,0.006068449310085518,694,113668,False
2024-10-06 04:30:00,85711,17311,0.006043565003325127,518,85193,False
2024-10-06 04:35:00,90096,18398,0.004683892736636477,422,89674,False
2024-10-06 04:40:00,82212,17854,0.0016542597187758478,136,82076,False
2024-10-06 04:45:00,169468,18933,0.005729695281705101,971,168497,True
2024-10-06 04:50:00,115894,17259,0.006221202132983589,721,115173,False
2024-10-06 04:55:00,94242,18380,0.0060482587381422296,570,93672,False
2024-10-06 05:00:00,91779,18251,0.0066899835474345986,614,91165,False
2024-10-06 05:05:00,97599,18263,0.005666041660262912,553,97046,False
2024-10-06 05:10:00,150286,18119,0.005309875836737953,798,149488,False
2024-10-06 05:15:00,114719,15662,0.004497947157837847,516,114203,False
2024-10-06 05:20:00,157690,15143,0.006392288667639039,1008,156682,True
2024-10-06 05:25:00,83792,14052,0.007172522436509452,601,83191,False
2024-10-06 05:30:00,63962,12699,0.007676432882023702,491,63471,False
2024-10-06 05:35:00,78553,13677,0.004595623337109976,361,78192,False
2024-10-06 05:40:00,61923,11735,0.00557143549246645,345,61578,False
2024-10-06 05:45:00,78940,13757,0.006498606536610083,513,78427,False
2024-10-06 05:50:00,39740,8918,0.004026170105686965,160,39580,False
2024-10-06 05:55:00,83015,13764,0.005480937180027706,455,82560,False
2024-10-06 06:00:00,78257,11685,0.0062997559323766565,493,77764,False
2024-10-06 06:05:00,91914,13522,0.007637574254194138,702,91212,False
2024-10-06 06:10:00,74872,13617,0.006704776151298215,502,74370,False
2024-10-06 06:15:00,122534,13284,0.006471673168263503,793,121741,False
2024-10-06 06:20:00,66241,13233,0.005857399495780559,388,65853,False
2024-10-06 06:25:00,64759,12286,0.006887073611389923,446,64313,False
2024-10-06 06:35:00,7528,3203,0.0009298618490967056,7,7521,False
2024-10-06 06:40:00,72869,13438,0.004309102636237632,314,72555,False
2024-10-06 06:45:00,1523,1191,0.021011162179908074,32,1491,False
2024-10-06 07:00:00,25493,6441,0.013493900286353116,344,25149,False
2024-10-06 07:05:00,59603,11545,0.012465815479086623,743,58860,False
2024-10-06 07:10:00,68181,12710,0.007876094513134157,537,67644,False
2024-10-06 07:15:00,30123,8221,0.00879726454868373,265,29858,False
2024-10-06 07:20:00,51036,10176,0.008347049141782272,426,50610,False
2024-10-06 07:25:00,169240,12625,0.007261876624911369,1229,168011,True
2024-10-06 07:30:00,100356,12676,0.01042289449559568,1046,99310,False
2024-10-06 07:35:00,69043,12541,0.008588850426545776,593,68450,False
2024-10-06 07:40:00,68182,12550,0.010735971370743011,732,67450,False
2024-10-06 07:45:00,67397,12521,0.008635399201744885,582,66815,False
2024-10-06 07:50:00,50412,10605,0.009164484646512734,462,49950,False
2024-10-06 07:55:00,64613,12182,0.008109823100614427,524,64089,False
2024-10-06 08:00:00,66402,12250,0.014171259901810186,941,65461,False
2024-10-06 08:05:00,93737,11743,0.012471062654021358,1169,92568,False
2024-10-06 08:10:00,110983,11627,0.008496796806718146,943,110040,False
2024-10-06 08:15:00,66245,12124,0.010280021133670466,681,65564,False
2024-10-06 08:20:00,64474,11968,0.007693023544374476,496,63978,False
2024-10-06 08:25:00,53694,11297,0.007505494096174619,403,53291,False
2024-10-06 08:30:00,64489,12017,0.014684674905797888,947,63542,False
2024-10-06 08:35:00,15460,5485,0.01164294954721863,180,15280,False
2024-10-06 08:40:00,86143,11699,0.007185726060155787,619,85524,False
2024-10-06 08:45:00,61255,11670,0.00839115174271488,514,60741,False
2024-10-06 08:50:00,45864,10372,0.004731379731379731,217,45647,False
2024-10-06 08:55:00,54770,11576,0.006280810662771591,344,54426,False
2024-10-06 09:00:00,59138,11295,0.009503195914640333,562,58576,False
2024-10-06 09:05:00,24032,5982,0.012067243675099867,290,23742,False
2024-10-06 09:10:00,57888,10847,0.008948313985627418,518,57370,False
2024-10-06 09:15:00,61302,9852,0.006313007732211021,387,60915,False
2024-10-06 09:20:00,62746,10938,0.0057374175246230836,360,62386,False
2024-10-06 09:25:00,130146,12004,0.006269881517680144,816,129330,False
2024-10-06 09:30:00,135062,11983,0.009366068916497609,1265,133797,False
2024-10-06 09:35:00,3960,1146,0.010101010101010102,40,3920,False
2024-10-06 10:15:00,33362,6578,0.005185540435225706,173,33189,False
2024-10-06 10:20:00,147418,12536,0.005643815544913104,832,146586,False
2024-10-06 10:25:00,110896,12805,0.004373467032174289,485,110411,False
2024-10-06 10:30:00,177756,13369,0.00825851166767929,1468,176288,True
2024-10-06 10:35:00,61429,11472,0.007960409578537823,489,60940,False
2024-10-06 10:40:00,80331,12675,0.008614358093388605,692,79639,False
2024-10-06 10:45:00,55630,9658,0.006417400683084666,357,55273,False
2024-10-06 10:50:00,70449,12369,0.005635282260926344,397,70052,False
2024-10-06 10:55:00,80621,13325,0.005159945919797571,416,80205,False
2024-10-06 11:00:00,81701,13703,0.009155334696025752,748,80953,False
2024-10-06 11:05:00,62095,12833,0.00926000483130687,575,61520,False
2024-10-06 11:10:00,46112,11275,0.009433553088133241,435,45677,False
2024-10-06 11:15:00,72869,13907,0.006600886522389494,481,72388,False
2024-10-06 11:20:00,77217,14344,0.006462307522954789,499,76718,False
2024-10-06 11:25:00,68416,13059,0.00624123012160898,427,67989,False
2024-10-06 11:30:00,67030,12820,0.008936297180367,599,66431,False
2024-10-06 11:35:00,103058,13268,0.008665023578955539,893,102165,False
2024-10-06 11:40:00,114650,14822,0.006184038377671173,709,113941,False
2024-10-06 11:45:00,79923,14855,0.006919159691202783,553,79370,False
2024-10-06 11:50:00,82292,15322,0.00823895396879405,678,81614,False
2024-10-06 11:55:00,85103,15738,0.006462756894586559,550,84553,False
2024-10-06 12:00:00,107772,15522,0.00857365549493375,924,106848,False
2024-10-06 12:05:00,155370,15399,0.009281070991825964,1442,153928,False
2024-10-06 12:10:00,68811,14463,0.0076586592259958435,527,68284,False
2024-10-06 12:15:00,77496,15363,0.006103540827913699,473,77023,False
2024-10-06 12:20:00,85652,16050,0.006164479521785831,528,85124,False
2024-10-06 12:25:00,91709,16586,0.006237119584773577,572,91137,False
2024-10-06 12:30:00,102690,17936,0.007994936215795112,821,101869,False
2024-10-06 12:35:00,84774,15891,0.005862646566164154,497,84277,False
2024-10-06 12:40:00,69448,13612,0.006551664554774795,455,68993,False
2024-10-06 12:45:00,62379,12589,0.005434521233107296,339,62040,False
2024-10-06 12:50:00,76769,14576,0.005510036603316443,423,76346,False
2024-10-06 12:55:00,87981,17135,0.005137472863459156,452,87529,False
2024-10-06 13:00:00,88946,17876,0.004609538371596249,410,88536,False
2024-10-06 13:05:00,103424,18446,0.005114866955445545,529,102895,False
2024-10-06 13:10:00,97660,18152,0.00519148064714315,507,97153,False
2024-10-06 13:15:00,79155,15946,0.005445012949276735,431,78724,False
2024-10-06 13:20:00,105185,18734,0.00520986832723297,548,104637,False
2024-10-06 13:25:00,103296,18812,0.005111524163568773,528,102768,False
2024-10-06 13:30:00,100557,18603,0.0045944091410841615,462,100095,False
2024-10-06 13:35:00,102871,19523,0.005978361248554014,615,102256,False
2024-10-06 13:40:00,77720,15986,0.004297478126608338,334,77386,False
2024-10-06 13:45:00,148297,16082,0.005360863672225331,795,147502,False
2024-10-06 13:50:00,100314,19473,0.0047251629882169984,474,99840,False
2024-10-06 13:55:00,102118,19828,0.0023306371060929513,238,101880,False
2024-10-06 14:00:00,117169,17985,0.0018093523030835801,212,116957,False
2024-10-06 14:05:00,225102,19114,0.004971079777167684,1119,223983,True
2024-10-06 14:10:00,154975,21458,0.00417486691401839,647,154328,False
2024-10-06 14:15:00,120012,20555,0.003941272539412725,473,119539,False
2024-10-06 14:20:00,121976,21164,0.0036564570079359875,446,121530,False
2024-10-06 14:25:00,127546,22129,0.002759788625280291,352,127194,False
2024-10-06 14:30:00,110315,21544,0.0037800843040384354,417,109898,False
2024-10-06 14:35:00,216747,22265,0.004752084227232672,1030,215717,True
2024-10-06 14:40:00,130513,22549,0.0052178710166803305,681,129832,False
2024-10-06 14:45:00,132813,22745,0.004404689299993224,585,132228,False
2024-10-06 14:50:00,86182,17064,0.003852312547863823,332,85850,False
2024-10-06 14:55:00,153100,17597,0.005016329196603527,768,152332,False
2024-10-06 15:00:00,278569,26669,0.004487218606521185,1250,277319,True
2024-10-06 15:05:00,183688,25959,0.004932276468794913,906,182782,True
2024-10-06 15:10:00,255698,20830,0.004157248003504134,1063,254635,True
2024-10-06 15:15:00,425068,25279,0.0037688087553050336,1602,423466,True
2024-10-06 15:20:00,381346,26432,0.0033591541539704103,1281,380065,True
2024-10-06 15:25:00,434890,29741,0.003113430982547311,1354,433536,True
2024-10-06 15:30:00,369650,29051,0.004379818747463817,1619,368031,True
2024-10-06 15:35:00,317305,26167,0.004541371866185531,1441,315864,True
2024-10-06 15:40:00,136350,22398,0.004085075174184085,557,135793,False
2024-10-06 15:45:00,209977,24183,0.0030717650028336436,645,209332,True
2024-10-06 15:50:00,355584,26555,0.0036418961483081352,1295,354289,True
2024-10-06 15:55:00,262646,29077,0.0036665321383154512,963,261683,True
2024-10-06 16:00:00,246602,29942,0.0028588575923958444,705,245897,True
2024-10-06 16:05:00,190091,28909,0.0034194149118053985,650,189441,True
2024-10-06 16:10:00,148008,27351,0.003932219880006486,582,147426,True
2024-10-06 16:15:00,144854,26401,0.0030651552597788117,444,144410,True
2024-10-06 16:20:00,140436,26120,0.0025349625452163265,356,140080,True
2024-10-06 16:25:00,204279,26288,0.0025651192731509357,524,203755,True
2024-10-06 16:30:00,114278,22839,0.002835191375417841,324,113954,False
2024-10-06 16:35:00,134296,25040,0.002732769404896646,367,133929,True
2024-10-06 16:40:00,113489,21449,0.003656742063107438,415,113074,False
2024-10-06 16:45:00,357066,27683,0.003531559991710216,1261,355805,True
2024-10-06 16:50:00,164162,26928,0.0026315468866120054,432,163730,True
2024-10-06 16:55:00,122777,23446,0.0023538610651832183,289,122488,True
2024-10-06 17:00:00,159441,22243,0.0028976235723559185,462,158979,True
2024-10-06 17:05:00,75858,16258,0.0026233225236626328,199,75659,False
2024-10-06 17:10:00,173747,18530,0.003297898668753993,573,173174,True
2024-10-06 17:15:00,483938,26200,0.003200823245952994,1549,482389,True
2024-10-06 17:20:00,265148,25903,0.0034886176776743553,925,264223,True
2024-10-06 17:25:00,144501,25226,0.00275430619857302,398,144103,True
2024-10-06 17:30:00,134882,22248,0.00409987989501935,553,134329,False
2024-10-06 17:35:00,153343,21840,0.003749763601859883,575,152768,True
2024-10-06 17:40:00,99778,19409,0.003998877508067911,399,99379,False
2024-10-06 17:45:00,148880,23560,0.0035464803868887696,528,148352,True
2024-10-06 17:50:00,137112,22428,0.0036466538304451837,500,136612,False
2024-10-06 17:55:00,292698,31015,0.0020840593376107797,610,292088,True
2024-10-06 18:00:00,305795,31265,0.0026749946859824392,818,304977,True
2024-10-06 18:05:00,200306,26969,0.0032899663514822323,659,199647,True
2024-10-06 18:10:00,93679,18835,0.003874934617150055,363,93316,False
2024-10-06 18:15:00,31853,8392,0.003484758107556588,111,31742,False
2024-10-06 18:20:00,180728,20844,0.003928555619494489,710,180018,True
2024-10-06 18:25:00,194849,19570,0.00493202428547234,961,193888,True
2024-10-06 18:30:00,141434,16074,0.005168488482260277,731,140703,False
2024-10-06 18:35:00,75511,13187,0.007349922527843626,555,74956,False
2024-10-06 18:40:00,9330,4690,0.005466237942122186,51,9279,False
2024-10-06 18:45:00,154719,17432,0.00454372119778437,703,154016,False
2024-10-06 18:50:00,224849,17085,0.0036646816307833257,824,224025,True
2024-10-06 18:55:00,184769,17245,0.003572027775222034,660,184109,True
2024-10-06 19:00:00,72575,14487,0.004836376162590424,351,72224,False
2024-10-06 19:05:00,76222,13402,0.004473773976017423,341,75881,False
2024-10-06 19:10:00,187430,14986,0.007101317825321454,1331,186099,True
2024-10-06 19:15:00,53222,10029,0.008924880688437112,475,52747,False
2024-10-06 19:20:00,7255,3080,0.007029634734665747,51,7204,False
2024-10-06 19:25:00,74665,12323,0.006790330141297797,507,74158,False
2024-10-06 19:30:00,73728,12168,0.008572048611111112,632,73096,False
2024-10-06 19:35:00,50958,9371,0.006593665371482397,336,50622,False
2024-10-06 19:40:00,108535,12407,0.007490671212051412,813,107722,False
2024-10-06 19:45:00,147282,12203,0.007882837006558846,1161,146121,False
2024-10-06 19:50:00,137237,11294,0.008168351100650699,1121,136116,False
2024-10-06 19:55:00,75922,10837,0.010537130212586602,800,75122,False
2024-10-06 20:00:00,73390,10649,0.01466139801062815,1076,72314,False
2024-10-06 20:05:00,65697,10159,0.010457098497648294,687,65010,False
2024-10-06 20:10:00,62252,10015,0.008240699094005013,513,61739,False
2024-10-06 20:15:00,59096,9456,0.00861310410180046,509,58587,False
2024-10-06 20:20:00,35185,6626,0.010686372033537018,376,34809,False
2024-10-06 20:25:00,55866,8957,0.009451186768338525,528,55338,False
2024-10-06 20:30:00,54787,8623,0.01173636081552193,643,54144,False
2024-10-06 20:35:00,45984,7718,0.01467901878914405,675,45309,False
2024-10-06 20:40:00,97127,8446,0.013425720963274887,1304,95823,False
2024-10-06 20:45:00,92216,8179,0.014682918365576473,1354,90862,False
2024-10-06 20:50:00,49648,7758,0.007392039961327747,367,49281,False
2024-10-06 20:55:00,48769,7598,0.005044187906251922,246,48523,False
2024-10-06 21:00:00,37178,6619,0.01621926946043359,603,36575,False
2024-10-06 21:05:00,41104,6427,0.015010704554301285,617,40487,False
2024-10-06 21:10:00,27187,5486,0.013499098834001544,367,26820,False
2024-10-06 21:15:00,39450,6128,0.012902408111533587,509,38941,False
2024-10-06 21:20:00,36787,5867,0.012830619512327725,472,36315,False
2024-10-06 21:25:00,34254,5486,0.014158930343901442,485,33769,False
2024-10-06 21:30:00,33414,5159,0.01717842820374693,574,32840,False
2024-10-06 21:35:00,911,619,0.013172338090010977,12,899,False
2024-10-06 21:40:00,30834,4977,0.01835635986248946,566,30268,False
2024-10-06 21:45:00,30260,4820,0.013450099140779907,407,29853,False
2024-10-06 21:50:00,28107,4612,0.016045824883480983,451,27656,False
2024-10-06 21:55:00,5275,1549,0.021232227488151657,112,5163,False
2024-10-06 22:00:00,28247,4384,0.02315290119304705,654,27593,False
2024-10-06 22:05:00,27774,4287,0.01973068337293872,548,27226,False
2024-10-06 22:10:00,12432,2438,0.022683397683397683,282,12150,False
2024-10-06 22:30:00,24682,2887,0.02580828133862734,637,24045,False
2024-10-06 22:35:00,48684,3729,0.023621723769616302,1150,47534,False
2024-10-06 22:40:00,47002,3707,0.017573720267222672,826,46176,False
2024-10-06 22:45:00,33206,3635,0.01824971390712522,606,32600,False
2024-10-06 22:50:00,24019,3709,0.02202423081726966,529,23490,False
2024-10-06 22:55:00,23495,3614,0.023026175782081295,541,22954,False
2024-10-06 23:00:00,24208,3708,0.026561467283542632,643,23565,False
2024-10-06 23:05:00,24314,3589,0.029283540347125114,712,23602,False
2024-10-06 23:10:00,4342,1301,0.019806540764624597,86,4256,False
2024-10-06 23:20:00,12415,2340,0.0220700765203383,274,12141,False
2024-10-06 23:25:00,24572,3691,0.024458733517825168,601,23971,False
2024-10-06 23:30:00,24485,3909,0.021768429650806616,533,23952,False
2024-10-06 23:35:00,19498,3280,0.02097651041132424,409,19089,False
2024-10-07 00:50:00,200,192,0.005,1,199,True
2024-10-07 00:55:00,31469,4945,0.015348438145476501,483,30986,False
2024-10-07 01:00:00,32328,5087,0.019023756495916852,615,31713,False
2024-10-07 01:05:00,20454,3718,0.01486261855871712,304,20150,False
2024-10-07 01:25:00,24078,4377,0.01370545726389235,330,23748,False
2024-10-07 01:30:00,35559,5564,0.0125425349419275,446,35113,False
2024-10-07 01:35:00,30475,5012,0.010828547990155866,330,30145,False
2024-10-07 01:40:00,19302,3713,0.013159258107968086,254,19048,False
2024-10-07 01:45:00,39513,6197,0.01154050565636626,456,39057,False
2024-10-07 01:50:00,31229,5788,0.014441704825642832,451,30778,False
2024-10-07 01:55:00,39934,6350,0.00906495717934592,362,39572,False
2024-10-07 02:00:00,48920,6446,0.00821749795584628,402,48518,False
2024-10-07 02:05:00,42398,6803,0.011132600594367659,472,41926,False
2024-10-07 02:10:00,26632,4918,0.012879243015920697,343,26289,False
2024-10-07 02:15:00,59638,6079,0.01646601160334015,982,58656,False
2024-10-07 02:20:00,87841,7116,0.013661046663858563,1200,86641,False
2024-10-07 02:25:00,45652,7404,0.008630509068605975,394,45258,False
2024-10-07 02:30:00,36978,6934,0.009978906376764563,369,36609,False
2024-10-07 02:35:00,33595,6053,0.009674058639678523,325,33270,False
2024-10-07 02:45:00,12440,3293,0.010691318327974276,133,12307,False
2024-10-07 02:50:00,52386,8051,0.009830870843355094,515,51871,False
2024-10-07 02:55:00,90900,8160,0.008547854785478547,777,90123,False
2024-10-07 03:00:00,87232,7489,0.007313829787234043,638,86594,False
2024-10-07 03:10:00,102440,7165,0.006589222959781336,675,101765,False
2024-10-07 03:15:00,171420,9360,0.008382919145957297,1437,169983,True
2024-10-07 03:20:00,95614,9684,0.010280921204007781,983,94631,False
2024-10-07 03:25:00,92296,9607,0.0074542775418219645,688,91608,False
2024-10-07 03:30:00,57362,7528,0.006955824413374708,399,56963,False
2024-10-07 03:35:00,55068,9342,0.007536137139536573,415,54653,False
2024-10-07 03:40:00,37563,8299,0.007693741181481777,289,37274,False
2024-10-07 03:45:00,61788,10364,0.00789797371657927,488,61300,False
2024-10-07 03:50:00,30991,7686,0.008583137039785744,266,30725,False
2024-10-07 03:55:00,63904,10678,0.011830245368052078,756,63148,False
2024-10-07 04:00:00,63009,10814,0.010950816550016665,690,62319,False
2024-10-07 04:05:00,18441,5046,0.009110135025215552,168,18273,False
2024-10-07 04:10:00,91418,11180,0.008302522479161653,759,90659,False
2024-10-07 04:15:00,64998,11063,0.007154066278962429,465,64533,False
2024-10-07 04:20:00,50622,9166,0.006657184623286318,337,50285,False
2024-10-07 04:25:00,7322,1955,0.00819448238186288,60,7262,False
2024-10-07 04:30:00,124802,10787,0.007724235188538645,964,123838,False
2024-10-07 04:35:00,55930,9798,0.007026640443411407,393,55537,False
2024-10-07 04:40:00,63094,10974,0.0056582242368529495,357,62737,False
2024-10-07 04:45:00,50731,9337,0.003902939031361495,198,50533,False
2024-10-07 04:50:00,103212,10683,0.007847924659923265,810,102402,False
2024-10-07 04:55:00,52057,10383,0.008106498645715273,422,51635,False
2024-10-07 05:00:00,47636,9082,0.00812410781761693,387,47249,False
2024-10-07 05:05:00,56632,10354,0.010365164571267129,587,56045,False
2024-10-07 05:10:00,17308,5933,0.007453200831985209,129,17179,False
2024-10-07 05:15:00,62848,10997,0.00898994399185336,565,62283,False
2024-10-07 05:20:00,19569,6332,0.008329500740967857,163,19406,False
2024-10-07 05:25:00,63659,11128,0.008042853327887652,512,63147,False
2024-10-07 05:30:00,93793,11162,0.00996876099495698,935,92858,False
2024-10-07 05:35:00,90618,10893,0.009810412942241055,889,89729,False
2024-10-07 05:40:00,36871,8732,0.009628163054975455,355,36516,False
2024-10-07 05:45:00,57350,10297,0.00934612031386225,536,56814,False
2024-10-07 05:50:00,56281,10257,0.008297649295499369,467,55814,False
2024-10-07 05:55:00,53757,10360,0.0103800435292148,558,53199,False
2024-10-07 06:00:00,63436,10605,0.010404186897030078,660,62776,False
2024-10-07 06:05:00,117489,10828,0.007217696975887105,848,116641,False
2024-10-07 06:10:00,88358,10340,0.007118766834921569,629,87729,False
2024-10-07 06:15:00,114818,10723,0.00782978278667108,899,113919,False
2024-10-07 06:20:00,59619,10721,0.007866619701772925,469,59150,False
2024-10-07 06:25:00,24283,5762,0.00848330107482601,206,24077,False
2024-10-07 06:45:00,17299,4536,0.00791953292097809,137,17162,False
2024-10-07 06:50:00,73041,10180,0.00888542051724374,649,72392,False
2024-10-07 06:55:00,81285,10056,0.007073875868856492,575,80710,False
2024-10-07 07:00:00,49559,9229,0.010270586573578967,509,49050,False
2024-10-07 07:05:00,51369,9463,0.00831240631509276,427,50942,False
2024-10-07 07:10:00,56368,10287,0.008905762134544422,502,55866,False
2024-10-07 07:15:00,54880,10024,0.008345481049562682,458,54422,False
2024-10-07 07:20:00,45072,8975,0.0075212992545260916,339,44733,False
2024-10-07 07:25:00,26924,6074,0.0098796612687565,266,26658,False
2024-10-07 07:30:00,62398,8432,0.010064425141831469,628,61770,False
2024-10-07 07:35:00,81900,9554,0.008168498168498168,669,81231,False
2024-10-07 07:40:00,26473,6951,0.006232765459147056,165,26308,False
2024-10-07 07:45:00,57874,9621,0.005339185126308878,309,57565,False
2024-10-07 07:50:00,61207,8949,0.005162808175535478,316,60891,False
2024-10-07 07:55:00,45870,9168,0.008327883148027033,382,45488,False
2024-10-07 08:00:00,49784,9231,0.008034709946970914,400,49384,False
2024-10-07 08:05:00,27131,5910,0.007887656186649957,214,26917,False
2024-10-07 08:10:00,44948,7054,0.010656758921420309,479,44469,False
2024-10-07 08:15:00,105042,9436,0.008815521410483427,926,104116,False
2024-10-07 08:20:00,35930,7500,0.008850542721959365,318,35612,False
2024-10-07 08:25:00,52045,9271,0.008588721298875973,447,51598,False
2024-10-07 08:30:00,36170,7736,0.007575338678462815,274,35896,False
2024-10-07 08:35:00,43284,8595,0.011528509379909435,499,42785,False
2024-10-07 08:40:00,50262,8963,0.010823285981457164,544,49718,False
2024-10-07 08:45:00,48993,8918,0.01014430632947564,497,48496,False
2024-10-07 08:50:00,49800,9073,0.010240963855421687,510,49290,False
2024-10-07 08:55:00,40061,8255,0.008986295898754399,360,39701,False
2024-10-07 09:00:00,48573,8712,0.010561423012784881,513,48060,False
2024-10-07 09:05:00,39444,8217,0.009076158604603996,358,39086,False
2024-10-07 09:10:00,47649,8809,0.010913135637683896,520,47129,False
2024-10-07 09:15:00,40434,8287,0.009051788099124498,366,40068,False
2024-10-07 09:20:00,47797,8855,0.008285038809967152,396,47401,False
2024-10-07 09:25:00,39265,8141,0.007793200050935948,306,38959,False
2024-10-07 09:30:00,48036,8805,0.012573902906153718,604,47432,False
2024-10-07 09:35:00,48590,8831,0.008828977155793373,429,48161,False
2024-10-07 09:40:00,30951,6411,0.009531194468676295,295,30656,False
2024-10-07 09:45:00,23372,5276,0.01112442238576074,260,23112,False
2024-10-07 09:50:00,48583,8794,0.009365415886215343,455,48128,False
2024-10-07 09:55:00,48446,8931,0.011167072616934318,541,47905,False
2024-10-07 10:00:00,56351,8839,0.012102713350251105,682,55669,False
2024-10-07 10:05:00,47699,8831,0.010398540849912995,496,47203,False
2024-10-07 10:10:00,46893,8625,0.01145160258460751,537,46356,False
2024-10-07 10:15:00,46982,8704,0.008066919245668554,379,46603,False
2024-10-07 10:20:00,15715,4027,0.006554247534202991,103,15612,False
2024-10-07 10:25:00,44400,8411,0.004009009009009009,178,44222,False
2024-10-07 10:30:00,49038,9026,0.010033035605040989,492,48546,False
2024-10-07 10:35:00,60432,8886,0.013850277998411438,837,59595,False
2024-10-07 10:40:00,78105,8883,0.008629409128736956,674,77431,False
2024-10-07 10:45:00,109139,8979,0.010051402340135056,1097,108042,False
2024-10-07 10:50:00,94244,8731,0.00971945163617843,916,93328,False
2024-10-07 10:55:00,40236,8045,0.010562680186897306,425,39811,False
2024-10-07 11:00:00,57636,8367,0.011138871538621694,642,56994,False
2024-10-07 11:05:00,79744,8741,0.008063302568218298,643,79101,False
2024-10-07 11:10:00,85834,8630,0.008038772514388238,690,85144,False
2024-10-07 11:15:00,9946,3050,0.006233661773577317,62,9884,False
2024-10-07 11:20:00,42067,8089,0.009888986616587825,416,41651,False
2024-10-07 11:25:00,31661,6531,0.010644009980733395,337,31324,False
2024-10-07 11:30:00,36792,7304,0.00986627527723418,363,36429,False
2024-10-07 11:35:00,46165,8598,0.009790967182930791,452,45713,False
2024-10-07 11:40:00,45259,8437,0.009743918336684417,441,44818,False
2024-10-07 11:45:00,39052,8190,0.00850148519922155,332,38720,False
2024-10-07 11:50:00,46475,8556,0.010973641742872513,510,45965,False
2024-10-07 11:55:00,32017,6500,0.010088390542524283,323,31694,False
2024-10-07 12:00:00,35298,6935,0.012408635050144484,438,34860,False
2024-10-07 12:05:00,46622,8650,0.01134657457852516,529,46093,False
2024-10-07 12:10:00,40967,7762,0.016964874167012475,695,40272,False
2024-10-07 12:15:00,32761,6704,0.01275907328836116,418,32343,False
2024-10-07 12:20:00,12626,3572,0.00982100427688896,124,12502,False
2024-10-07 12:25:00,48443,9196,0.009743409780566852,472,47971,False
2024-10-07 12:30:00,20851,4964,0.005275526353652103,110,20741,False
2024-10-07 12:35:00,18433,4650,0.009927846796506266,183,18250,False
2024-10-07 12:40:00,49735,9230,0.010153815220669549,505,49230,False
2024-10-07 12:45:00,49633,9319,0.010758970846009712,534,49099,False
2024-10-07 12:50:00,48027,9149,0.011639286234826244,559,47468,False
2024-10-07 12:55:00,51028,9544,0.010190483656031982,520,50508,False
2024-10-07 13:00:00,87348,9393,0.011746118972386317,1026,86322,False
2024-10-07 13:05:00,126750,9215,0.010761341222879684,1364,125386,False
2024-10-07 13:10:00,77512,9346,0.011314377128702653,877,76635,False
2024-10-07 13:15:00,71623,9501,0.009005487064211217,645,70978,False
2024-10-07 13:20:00,35745,8210,0.012365365785424534,442,35303,False
2024-10-07 13:25:00,51820,9602,0.01597838672327287,828,50992,False
2024-10-07 13:30:00,51601,9581,0.014553981511986202,751,50850,False
2024-10-07 13:35:00,75635,9388,0.011767039069213989,890,74745,False
2024-10-07 13:40:00,50999,9671,0.012490440989039,637,50362,False
2024-10-07 13:45:00,51880,9847,0.012509637625289128,649,51231,False
2024-10-07 13:50:00,45015,9663,0.008797067644118627,396,44619,False
2024-10-07 13:55:00,54204,10459,0.008763190908420043,475,53729,False
2024-10-07 14:00:00,52659,10149,0.00881140925577774,464,52195,False
2024-10-07 14:05:00,45186,9643,0.00860886115168415,389,44797,False
2024-10-07 14:10:00,53671,10495,0.007434182333103538,399,53272,False
2024-10-07 14:15:00,44311,9553,0.011058202252262417,490,43821,False
2024-10-07 14:20:00,47826,10167,0.013089114707481286,626,47200,False
2024-10-07 14:25:00,58169,10996,0.007168766868950816,417,57752,False
2024-10-07 14:30:00,15571,4397,0.009440626806242374,147,15424,False
2024-10-07 14:35:00,30268,6903,0.009812343068587286,297,29971,False
2024-10-07 14:40:00,49805,10394,0.011906435096877823,593,49212,False
2024-10-07 14:45:00,82447,11025,0.011850036993462466,977,81470,False
2024-10-07 14:50:00,69379,11251,0.015999077530664898,1110,68269,False
2024-10-07 14:55:00,41667,9576,0.010679914560683514,445,41222,False
2024-10-07 15:00:00,54114,10293,0.011974720035480653,648,53466,False
2024-10-07 15:05:00,44935,8930,0.012729498164014688,572,44363,False
2024-10-07 15:10:00,64767,11069,0.013154847375978508,852,63915,False
2024-10-07 15:15:00,103948,11198,0.013198907145880633,1372,102576,False
2024-10-07 15:20:00,98279,11207,0.011497878488792112,1130,97149,False
2024-10-07 15:25:00,98307,11241,0.010131526747840947,996,97311,False
2024-10-07 15:30:00,114906,11588,0.010765321219083425,1237,113669,False
2024-10-07 15:35:00,59547,11512,0.008531076292676373,508,59039,False
2024-10-07 15:40:00,22280,5819,0.0066876122082585275,149,22131,False
2024-10-07 15:45:00,21426,5518,0.010034537477830672,215,21211,False
2024-10-07 15:50:00,55305,11241,0.007955881023415604,440,54865,False
2024-10-07 15:55:00,63311,11792,0.011498791679171077,728,62583,False
2024-10-07 16:00:00,63703,11722,0.009057658195061456,577,63126,False
2024-10-07 16:05:00,105223,11911,0.010501506324662858,1105,104118,False
2024-10-07 16:10:00,103436,11645,0.008575350941645075,887,102549,False
2024-10-07 16:15:00,71702,12708,0.01044601266352403,749,70953,False
2024-10-07 16:20:00,62502,11792,0.008639723528847077,540,61962,False
2024-10-07 16:25:00,58872,10707,0.010718168229378992,631,58241,False
2024-10-07 16:30:00,109176,11641,0.010102953029969957,1103,108073,False
2024-10-07 16:35:00,66359,12134,0.008182763453337152,543,65816,False
2024-10-07 16:40:00,67729,12899,0.007456185681170548,505,67224,False
2024-10-07 16:45:00,57428,11939,0.00992547189524274,570,56858,False
2024-10-07 16:50:00,125154,13083,0.013071895424836602,1636,123518,False
2024-10-07 16:55:00,116785,12768,0.008117480840861412,948,115837,False
2024-10-07 17:00:00,49152,9544,0.009318033854166666,458,48694,False
2024-10-07 17:05:00,51736,9869,0.010920828823256533,565,51171,False
2024-10-07 17:10:00,72680,11722,0.010676940011007155,776,71904,False
2024-10-07 17:15:00,68632,12325,0.01124839724909663,772,67860,False
2024-10-07 17:20:00,124494,12026,0.00973540893537038,1212,123282,False
2024-10-07 17:25:00,67754,9634,0.011246568468282316,762,66992,False
2024-10-07 17:30:00,48952,9441,0.01348259519529335,660,48292,False
2024-10-07 17:35:00,69765,12232,0.01047803339783559,731,69034,False
2024-10-07 17:40:00,89226,11529,0.011510097953511308,1027,88199,False
2024-10-07 17:45:00,111428,11148,0.013111605700542053,1461,109967,False
2024-10-07 17:50:00,89330,12165,0.010836225232284787,968,88362,False
2024-10-07 17:55:00,133368,11780,0.010572251214684181,1410,131958,False
2024-10-07 18:00:00,95942,11290,0.01413353901315378,1356,94586,False
2024-10-07 18:05:00,111236,10957,0.010221511021611708,1137,110099,False
2024-10-07 18:10:00,119516,10986,0.0124334817095619,1486,118030,False
2024-10-07 18:15:00,56473,10783,0.011687000867671276,660,55813,False
2024-10-07 18:20:00,124501,11698,0.010522003839326591,1310,123191,False
2024-10-07 18:25:00,71722,11118,0.009341624606118067,670,71052,False
2024-10-07 18:30:00,52415,9784,0.00555184584565487,291,52124,False
2024-10-07 18:35:00,116858,10424,0.01084221876123158,1267,115591,False
2024-10-07 18:40:00,66428,11236,0.011997952670560606,797,65631,False
2024-10-07 18:45:00,61770,10822,0.00995628946090335,615,61155,False
2024-10-07 18:50:00,122341,11319,0.010012996460712272,1225,121116,False
2024-10-07 18:55:00,57159,10114,0.009324865725432565,533,56626,False
2024-10-07 19:00:00,53213,9988,0.012215060229643132,650,52563,False
2024-10-07 19:05:00,77408,10333,0.01170421661843737,906,76502,False
2024-10-07 19:10:00,23161,5866,0.006649108415007988,154,23007,False
2024-10-07 19:15:00,75326,8862,0.014297852003292356,1077,74249,False
2024-10-07 19:20:00,61322,8613,0.01374710544339715,843,60479,False
2024-10-07 19:25:00,44544,7932,0.017308728448275863,771,43773,False
2024-10-07 19:30:00,44460,7775,0.01981556455240666,881,43579,False
2024-10-07 19:35:00,41461,7345,0.016666264682472686,691,40770,False
2024-10-07 19:40:00,32363,6413,0.017952600191576802,581,31782,False
2024-10-07 19:45:00,38218,6681,0.026558166309069025,1015,37203,False
2024-10-07 19:50:00,68269,6686,0.016976958795353676,1159,67110,False
2024-10-07 19:55:00,71690,6391,0.017659366717812805,1266,70424,False
2024-10-07 20:00:00,33981,6057,0.023336570436420352,793,33188,False
2024-10-07 20:05:00,33773,6007,0.02587866046842152,874,32899,False
2024-10-07 20:10:00,14166,3286,0.022095157419172666,313,13853,False
2024-10-07 20:20:00,15311,3310,0.02462282019463131,377,14934,False
2024-10-07 20:25:00,30063,5342,0.024614975218707383,740,29323,False
2024-10-07 20:30:00,28354,5042,0.031318332510404175,888,27466,False
2024-10-07 20:40:00,4197,1422,0.01929949964260186,81,4116,False
2024-10-07 20:45:00,25107,4513,0.011988688413589835,301,24806,False
2024-10-07 20:50:00,25008,4451,0.024392194497760717,610,24398,False
2024-10-07 20:55:00,36340,4319,0.021684094661529995,788,35552,False
2024-10-07 21:00:00,23105,4183,0.031421770179614804,726,22379,False
2024-10-07 21:05:00,22199,4009,0.03153295193477184,700,21499,False
2024-10-07 21:10:00,21975,3786,0.048737201365187714,1071,20904,False
2024-10-07 21:15:00,14641,2853,0.035516699678983674,520,14121,False
2024-10-07 21:20:00,1359,671,0.03164091243561442,43,1316,False
2024-10-07 21:25:00,19622,3452,0.030425033126082968,597,19025,False
2024-10-07 21:30:00,18391,3312,0.040672067859278994,748,17643,False
2024-10-07 21:35:00,19171,3245,0.03990402169944186,765,18406,False
2024-10-07 21:40:00,17682,3157,0.015043547110055424,266,17416,False
2024-10-07 21:45:00,17378,3019,0.032800092070433884,570,16808,False
2024-10-07 21:50:00,16390,2995,0.02953020134228188,484,15906,False
2024-10-07 21:55:00,16148,2962,0.030653950953678476,495,15653,False
2024-10-07 22:00:00,16609,2816,0.0493708230477452,820,15789,False
2024-10-07 22:05:00,10129,2006,0.03899693948069898,395,9734,False
2024-10-07 22:10:00,12344,2334,0.03321451717433571,410,11934,False
2024-10-07 22:15:00,16030,2749,0.056144728633811605,900,15130,False
2024-10-07 22:20:00,16388,2836,0.03478154747376129,570,15818,False
2024-10-07 22:25:00,15391,2689,0.03651484633876941,562,14829,False
2024-10-07 22:30:00,13575,2439,0.03263351749539595,443,13132,False
2024-10-07 22:45:00,11609,2139,0.04220863123438711,490,11119,False
2024-10-07 22:50:00,15428,2670,0.04122374902774177,636,14792,False
2024-10-07 22:55:00,15846,2720,0.04196642685851319,665,15181,False
2024-10-07 23:00:00,15644,2695,0.04244438762464843,664,14980,False
2024-10-07 23:05:00,15589,2671,0.03194560266854834,498,15091,False
2024-10-07 23:10:00,5498,1299,0.03001091305929429,165,5333,False
2024-10-07 23:15:00,10084,1964,0.04135263784212614,417,9667,False
2024-10-07 23:20:00,16272,2775,0.047750737463126844,777,15495,False
2024-10-07 23:25:00,16756,2833,0.035091907376462166,588,16168,False
2024-10-07 23:30:00,31376,2827,0.037162162162162164,1166,30210,False
2024-10-07 23:35:00,31530,2884,0.028036790358388835,884,30646,False
2024-10-07 23:40:00,25056,2958,0.02941411238825032,737,24319,False
2024-10-07 23:45:00,16599,2907,0.03566479908428218,592,16007,False
2024-10-07 23:50:00,16513,2926,0.03330709138254708,550,15963,False
2024-10-07 23:55:00,7846,1792,0.02523578893703798,198,7648,False
2024-10-08 00:00:00,999,522,0.03803803803803804,38,961,True
2024-10-08 00:05:00,17068,3077,0.03275134755097258,559,16509,False
2024-10-08 00:10:00,17687,3175,0.031039746706620682,549,17138,False
2024-10-08 00:15:00,17068,3061,0.033923131005390204,579,16489,False
2024-10-08 00:20:00,12714,2462,0.03067484662576687,390,12324,False
2024-10-08 00:40:00,4955,1357,0.03773965691220989,187,4768,False
2024-10-08 00:45:00,19937,3383,0.054872849475848924,1094,18843,False
2024-10-08 00:50:00,20261,3551,0.05137949755688268,1041,19220,False
2024-10-08 00:55:00,20754,3530,0.053580032764768235,1112,19642,False
2024-10-08 01:00:00,12128,2985,0.03092018469656992,375,11753,False
2024-10-08 01:05:00,21627,3876,0.02797429139501549,605,21022,False
2024-10-08 01:10:00,22338,4023,0.029143164114961054,651,21687,False
2024-10-08 01:15:00,22172,3838,0.03707378675807325,822,21350,False
2024-10-08 01:20:00,3284,1162,0.052679658952496954,173,3111,False
2024-10-08 01:25:00,202,180,0.039603960396039604,8,194,True
2024-10-08 01:30:00,22500,3889,0.03164444444444445,712,21788,False
2024-10-08 01:35:00,23647,4048,0.033873218590095996,801,22846,False
2024-10-08 01:40:00,24495,4207,0.028373137374974485,695,23800,False
2024-10-08 01:45:00,23494,4117,0.035540989188729034,835,22659,False
2024-10-08 01:50:00,78,75,0.02564102564102564,2,76,True
2024-10-08 01:55:00,25906,4461,0.03161429784605883,819,25087,False
2024-10-08 02:00:00,26415,4577,0.03361726291879614,888,25527,False
2024-10-08 02:05:00,26418,4680,0.026383526383526385,697,25721,False
2024-10-08 02:10:00,27187,4912,0.022657887961157905,616,26571,False
2024-10-08 02:15:00,64448,4967,0.02057472691161867,1326,63122,False
2024-10-08 02:20:00,76702,5017,0.009439128054027274,724,75978,False
2024-10-08 02:25:00,30537,5009,0.02144938926548122,655,29882,False
2024-10-08 02:30:00,33007,5217,0.032296179598267034,1066,31941,False
2024-10-08 02:35:00,58824,5352,0.02097783217734258,1234,57590,False
2024-10-08 02:40:00,62454,5554,0.02545873763089634,1590,60864,False
2024-10-08 02:45:00,75711,5624,0.02406519528205941,1822,73889,False
2024-10-08 02:50:00,45408,5828,0.01682522903453136,764,44644,False
2024-10-08 02:55:00,30924,5906,0.0057883844263355326,179,30745,False
2024-10-08 03:00:00,42837,6021,0.012045661460886616,516,42321,False
2024-10-08 03:05:00,55443,6311,0.010172609707266923,564,54879,False
2024-10-08 03:10:00,34486,6469,0.021081018384271878,727,33759,False
2024-10-08 03:15:00,35359,6585,0.02203116603976357,779,34580,False
2024-10-08 03:20:00,1520,915,0.01644736842105263,25,1495,False
2024-10-08 03:25:00,24564,4511,0.016446832763393582,404,24160,False
2024-10-08 03:30:00,65338,6937,0.019483302213107227,1273,64065,False
2024-10-08 03:35:00,37181,7130,0.011941583066620048,444,36737,False
2024-10-08 03:40:00,28701,5783,0.01724678582627783,495,28206,False
2024-10-08 03:50:00,43450,6069,0.01622554660529344,705,42745,False
2024-10-08 03:55:00,42055,7396,0.014956604446558079,629,41426,False
2024-10-08 04:00:00,38460,7351,0.01999479979199168,769,37691,False
2024-10-08 04:05:00,31113,6958,0.020730884196316652,645,30468,False
2024-10-08 04:10:00,41130,7729,0.01740821784585461,716,40414,False
2024-10-08 04:15:00,55509,7578,0.013763533841359058,764,54745,False
2024-10-08 04:20:00,39082,7562,0.010414001330535796,407,38675,False
2024-10-08 04:25:00,38410,7511,0.013902629523561572,534,37876,False
2024-10-08 04:30:00,37425,7242,0.016860387441549766,631,36794,False
2024-10-08 04:35:00,38034,7402,0.012883209759688699,490,37544,False
2024-10-08 04:40:00,53404,7409,0.013987716275934387,747,52657,False
2024-10-08 04:45:00,46813,7426,0.013222822720184563,619,46194,False
2024-10-08 04:50:00,46282,7348,0.018754591417829827,868,45414,False
2024-10-08 04:55:00,37946,7252,0.017235018183734782,654,37292,False
2024-10-08 05:00:00,25287,5396,0.02590263771898604,655,24632,False
2024-10-08 05:05:00,35601,7060,0.002949355355186652,105,35496,False
2024-10-08 05:10:00,37157,7317,0.0021799391770056784,81,37076,False
2024-10-08 05:15:00,29711,6233,0.014540069334589883,432,29279,False
2024-10-08 05:20:00,37661,7168,0.018958604391811157,714,36947,False
2024-10-08 05:25:00,12524,4184,0.017646119450654744,221,12303,False
2024-10-08 05:30:00,36997,7230,0.01624456036975971,601,36396,False
2024-10-08 05:35:00,36187,7037,0.014894851742338408,539,35648,False
2024-10-08 05:40:00,35959,7069,0.013904724825495703,500,35459,False
2024-10-08 05:45:00,54309,6918,0.01471211033162091,799,53510,False
2024-10-08 05:50:00,41579,7042,0.02111642896654561,878,40701,False
2024-10-08 05:55:00,35360,6831,0.017562217194570136,621,34739,False
2024-10-08 06:00:00,171,158,0.04678362573099415,8,163,True
2024-10-08 06:05:00,3872,1630,0.014979338842975207,58,3814,False
2024-10-08 06:10:00,33848,6641,0.017814937367052707,603,33245,False
2024-10-08 06:15:00,35203,6824,0.015850921796437805,558,34645,False
2024-10-08 06:20:00,10114,3303,0.016511765869092348,167,9947,False
2024-10-08 06:25:00,34565,6747,0.01935483870967742,669,33896,False
2024-10-08 06:30:00,34346,6738,0.022826530018051593,784,33562,False
2024-10-08 06:35:00,48394,6576,0.020808364673306608,1007,47387,False
2024-10-08 06:40:00,52309,6565,0.01821866218050431,953,51356,False
2024-10-08 06:45:00,34147,6590,0.020265323454476236,692,33455,False
2024-10-08 06:50:00,55129,6542,0.01975366866803316,1089,54040,False
2024-10-08 06:55:00,67876,6590,0.02295362130944664,1558,66318,False
2024-10-08 07:00:00,59565,6846,0.03112566104255855,1854,57711,False
2024-10-08 07:05:00,69569,7376,0.019908292486596042,1385,68184,False
2024-10-08 07:10:00,42714,7156,0.020859671302149177,891,41823,False
2024-10-08 07:15:00,64264,7591,0.0189686294037097,1219,63045,False
2024-10-08 07:20:00,83512,8010,0.01788964460197337,1494,82018,False
2024-10-08 07:25:00,45417,7733,0.022722769007199946,1032,44385,False
2024-10-08 07:30:00,40975,7742,0.021037217815741305,862,40113,False
2024-10-08 07:35:00,23088,5340,0.022002772002772,508,22580,False
2024-10-08 07:40:00,56964,6828,0.020837722070079348,1187,55777,False
2024-10-08 07:45:00,71060,6713,0.02319166901210245,1648,69412,False
2024-10-08 07:50:00,64633,6735,0.020732443179180913,1340,63293,False
2024-10-08 07:55:00,141193,6920,0.017217567443145197,2431,138762,False
2024-10-08 08:00:00,114466,6967,0.027449198888752992,3142,111324,False
2024-10-08 08:05:00,51800,5895,0.02225868725868726,1153,50647,False
2024-10-08 08:10:00,72254,6786,0.01918232900600659,1386,70868,False
2024-10-08 08:15:00,57636,6223,0.01851273509612048,1067,56569,False
2024-10-08 08:20:00,7636,2375,0.022132006286013618,169,7467,False
2024-10-08 08:25:00,35883,6795,0.020009475238971102,718,35165,False
2024-10-08 08:30:00,35315,6524,0.022709896644485347,802,34513,False
2024-10-08 08:35:00,56885,6682,0.025982244880021096,1478,55407,False
2024-10-08 08:40:00,69054,6521,0.022446201523445418,1550,67504,False
2024-10-08 08:45:00,25188,4942,0.019572812450373192,493,24695,False
2024-10-08 08:50:00,30382,5999,0.020110591797775,611,29771,False
2024-10-08 08:55:00,33880,6512,0.013636363636363636,462,33418,False
2024-10-08 09:00:00,56248,6610,0.0270054046366093,1519,54729,False
2024-10-08 09:05:00,33795,6506,0.017546974404497706,593,33202,False
2024-10-08 09:10:00,33351,6449,0.017210878234535695,574,32777,False
2024-10-08 09:15:00,34480,6502,0.01441415313225058,497,33983,False
2024-10-08 09:20:00,35139,6606,0.016676627109479494,586,34553,False
2024-10-08 09:25:00,50645,5841,0.01565801164971863,793,49852,False
2024-10-08 09:30:00,36513,6851,0.017719716265439705,647,35866,False
2024-10-08 09:35:00,13773,3424,0.016554127641036812,228,13545,False
2024-10-08 09:50:00,26558,3369,0.01596505760975977,424,26134,False
2024-10-08 09:55:00,40655,6822,0.030721928422088304,1249,39406,False
2024-10-08 10:00:00,15581,3713,0.02920223348950645,455,15126,False
2024-10-08 10:15:00,5665,1981,0.018534863195057368,105,5560,False
2024-10-08 10:20:00,36672,6920,0.017779232111692845,652,36020,False
2024-10-08 10:25:00,31391,6236,0.02105699085725208,661,30730,False
2024-10-08 10:40:00,17018,3956,0.0218004465859678,371,16647,False
2024-10-08 10:45:00,44931,6880,0.024860341412387885,1117,43814,False
2024-10-08 10:50:00,65891,7047,0.02508688591765188,1653,64238,False
2024-10-08 10:55:00,39246,7258,0.024384650665035926,957,38289,False
2024-10-08 11:00:00,45240,7026,0.02385057471264368,1079,44161,False
2024-10-08 11:05:00,84766,6980,0.025033621971073308,2122,82644,False
2024-10-08 11:10:00,84662,6964,0.02227681840731379,1886,82776,False
2024-10-08 11:15:00,55505,7089,0.027258805513016845,1513,53992,False
2024-10-08 11:20:00,31276,5209,0.02765698938483182,865,30411,False
2024-10-08 11:25:00,80424,7277,0.03288819257932955,2645,77779,False
2024-10-08 11:30:00,103312,7341,0.025911801146043054,2677,100635,False
2024-10-08 11:35:00,75326,7186,0.018320367469399676,1380,73946,False
2024-10-08 11:40:00,53372,6593,0.017349921307052388,926,52446,False
2024-10-08 11:50:00,40012,4521,0.016645006498050584,666,39346,False
2024-10-08 11:55:00,77888,7498,0.006239728841413311,486,77402,False
2024-10-08 12:00:00,108526,7500,0.016401599616681715,1780,106746,False
2024-10-08 12:05:00,91198,7744,0.01440821070637514,1314,89884,False
2024-10-08 12:10:00,69611,7877,0.01422189021849995,990,68621,False
2024-10-08 12:15:00,46866,7827,0.018776938505526395,880,45986,False
2024-10-08 12:20:00,17389,5127,0.014434412559664156,251,17138,False
2024-10-08 12:25:00,41854,7909,0.01036937927079849,434,41420,False
2024-10-08 12:30:00,25629,6360,0.011510398376838737,295,25334,False
2024-10-08 12:35:00,64226,7965,0.01650421947497898,1060,63166,False
2024-10-08 12:40:00,79140,8179,0.014392216325499115,1139,78001,False
2024-10-08 12:45:00,75106,8185,0.014805741219077038,1112,73994,False
2024-10-08 12:50:00,28006,5738,0.028743840605584516,805,27201,False
2024-10-08 12:55:00,13790,3771,0.011457577955039884,158,13632,False
2024-10-08 13:00:00,58584,8216,0.012460740133824935,730,57854,False
2024-10-08 13:05:00,100761,8242,0.014162225464217306,1427,99334,False
2024-10-08 13:10:00,84093,8459,0.012652658366332514,1064,83029,False
2024-10-08 13:15:00,33989,7587,0.015887493012445204,540,33449,False
2024-10-08 13:20:00,46429,8776,0.012987572422408408,603,45826,False
2024-10-08 13:25:00,38695,8229,0.01584184003101176,613,38082,False
2024-10-08 13:30:00,45441,8693,0.017385180783873595,790,44651,False
2024-10-08 13:35:00,22189,5207,0.018072017666411287,401,21788,False
2024-10-08 13:40:00,30511,6525,0.016649732883222444,508,30003,False
2024-10-08 13:45:00,44654,8724,0.014645944372284678,654,44000,False
2024-10-08 13:50:00,7525,2683,0.010099667774086378,76,7449,False
2024-10-08 13:55:00,47790,9175,0.011592383343795773,554,47236,False
2024-10-08 14:00:00,35516,8110,0.016724856402748057,594,34922,False
2024-10-08 14:05:00,48839,9280,0.015458956981101168,755,48084,False
2024-10-08 14:10:00,51202,8642,0.012870590992539354,659,50543,False
2024-10-08 14:15:00,49373,9460,0.015858870232718286,783,48590,False
2024-10-08 14:20:00,42552,9095,0.014758413235570596,628,41924,False
2024-10-08 14:25:00,50162,9682,0.003189665483832383,160,50002,False
2024-10-08 14:30:00,52827,10240,0.007552955874836731,399,52428,False
2024-10-08 14:35:00,62831,10190,0.01422864509557384,894,61937,False
2024-10-08 14:40:00,54102,10045,0.01650585930279842,893,53209,False
2024-10-08 14:45:00,64972,10243,0.011805085267499847,767,64205,False
2024-10-08 14:50:00,101060,10447,0.010864832772610331,1098,99962,False
2024-10-08 14:55:00,102912,10101,0.0012437810945273632,128,102784,False
2024-10-08 15:00:00,45695,8265,0.002844950213371266,130,45565,False
2024-10-08 15:05:00,52045,9991,0.008896147564607552,463,51582,False
2024-10-08 15:10:00,39008,7924,0.016047990155865464,626,38382,False
2024-10-08 15:15:00,42614,8504,0.012883090064298119,549,42065,False
2024-10-08 15:20:00,35921,7432,0.011469613874892124,412,35509,False
2024-10-08 15:25:00,56735,10554,0.012972591874504275,736,55999,False
2024-10-08 15:30:00,56455,10707,0.012027278363298203,679,55776,False
2024-10-08 15:35:00,56989,10762,0.012125146958184913,691,56298,False
2024-10-08 15:40:00,57264,10671,0.013883067896060352,795,56469,False
2024-10-08 15:45:00,56687,10542,0.01857568754740946,1053,55634,False
2024-10-08 15:50:00,59598,11217,0.011929930534581697,711,58887,False
2024-10-08 15:55:00,30694,8155,0.010360331009317781,318,30376,False
2024-10-08 16:00:00,63948,11834,0.009554638143491587,611,63337,False
2024-10-08 16:05:00,72774,13751,0.010663148926814522,776,71998,False
2024-10-08 16:10:00,79941,15819,0.00793084900113834,634,79307,False
2024-10-08 16:15:00,4107,2164,0.0019478938397857316,8,4099,False
2024-10-08 16:20:00,131371,12338,0.006059175921626539,796,130575,False
2024-10-08 16:25:00,40529,8444,0.010042192010659035,407,40122,False
2024-10-08 16:30:00,65536,12135,0.0112762451171875,739,64797,False
2024-10-08 16:35:00,34020,7467,0.010728982951205173,365,33655,False
2024-10-08 16:40:00,40330,8428,0.01011653855690553,408,39922,False
2024-10-08 17:00:00,48911,9858,0.01028398519760381,503,48408,False
2024-10-08 17:05:00,124874,11153,0.008488556464916636,1060,123814,False
2024-10-08 17:10:00,82683,10840,0.010413265121004317,861,81822,False
2024-10-08 17:15:00,62097,11199,0.011417620819041177,709,61388,False
2024-10-08 17:20:00,83284,10669,0.013832188655684165,1152,82132,False
2024-10-08 17:25:00,82361,8307,0.009373368463228955,772,81589,False
2024-10-08 17:40:00,36978,7561,0.01271026015468657,470,36508,False
2024-10-08 17:45:00,44942,8584,0.014374082150327087,646,44296,False
2024-10-08 18:00:00,37708,7250,0.01129733743502705,426,37282,False
2024-10-08 18:05:00,103411,10375,0.013132065254179924,1358,102053,False
2024-10-08 18:10:00,99704,10172,0.013600256760009628,1356,98348,False
2024-10-08 18:15:00,99362,10743,0.010899539059197681,1083,98279,False
2024-10-08 18:20:00,11520,3532,0.009461805555555555,109,11411,False
2024-10-08 18:25:00,16384,4358,0.0093994140625,154,16230,False
2024-10-08 18:45:00,11584,3440,0.007510359116022099,87,11497,False
2024-10-08 18:50:00,61597,10687,0.010503758299917204,647,60950,False
2024-10-08 18:55:00,58256,10040,0.011586789343586926,675,57581,False
2024-10-08 19:00:00,96758,9574,0.011988672771243722,1160,95598,False
2024-10-08 19:05:00,17930,4500,0.009481316229782488,170,17760,False
2024-10-08 19:15:00,59209,5238,0.011146954010370046,660,58549,False
2024-10-08 19:20:00,132822,7773,0.018046709129511677,2397,130425,False
2024-10-08 19:25:00,57685,5197,0.010782699141891306,622,57063,False
2024-10-08 19:30:00,10052,2830,0.014424990051730998,145,9907,False
2024-10-08 19:35:00,38901,6918,0.015089586385954088,587,38314,False
2024-10-08 19:40:00,25738,5042,0.014803014997280286,381,25357,False
2024-10-08 19:55:00,28424,4409,0.017837039121868844,507,27917,False
2024-10-08 20:00:00,63948,5815,0.012885469443923188,824,63124,False
2024-10-08 20:05:00,61256,5550,0.012537547342301163,768,60488,False
2024-10-08 20:10:00,22252,2732,0.017706273593384864,394,21858,False
2024-10-08 20:20:00,28592,5153,0.020565193060996082,588,28004,False
2024-10-08 20:25:00,28011,4980,0.023383670700796114,655,27356,False
2024-10-08 20:30:00,20094,3768,0.03199960187120533,643,19451,False
2024-10-08 20:40:00,7889,1966,0.03561921663075168,281,7608,False
2024-10-08 20:45:00,24189,4159,0.03319690768531151,803,23386,False
2024-10-08 20:50:00,24251,4080,0.030060616057069812,729,23522,False
2024-10-08 20:55:00,22947,4015,0.02636510219200767,605,22342,False
2024-10-08 21:00:00,15383,2917,0.04231944354157186,651,14732,False
2024-10-08 21:05:00,21120,3688,0.04081439393939394,862,20258,False
2024-10-08 21:10:00,21575,3738,0.037219003476245655,803,20772,False
2024-10-08 21:15:00,20090,3513,0.043802887008461924,880,19210,False
2024-10-08 21:20:00,3752,1134,0.040245202558635396,151,3601,False
2024-10-08 21:35:00,6050,1401,0.041487603305785124,251,5799,False
2024-10-08 21:40:00,17217,2996,0.013533135854097694,233,16984,False
2024-10-08 21:45:00,24009,2841,0.0392352867674622,942,23067,False
2024-10-08 21:50:00,33616,2779,0.04450261780104712,1496,32120,False
2024-10-08 21:55:00,33170,2766,0.042387699728670486,1406,31764,False
2024-10-08 22:00:00,24795,2705,0.0573502722323049,1422,23373,False
2024-10-08 22:05:00,16537,2704,0.04746931124145855,785,15752,False
2024-10-08 22:10:00,22742,2533,0.04040981444024272,919,21823,False
2024-10-08 22:15:00,31078,2480,0.05116159341012935,1590,29488,False
2024-10-08 22:20:00,30406,2548,0.038545024008419394,1172,29234,False
2024-10-08 22:25:00,24701,2541,0.02692198696409052,665,24036,False
2024-10-08 22:30:00,15239,2480,0.045147319377911936,688,14551,False
2024-10-08 22:35:00,16215,2405,0.05291396854764107,858,15357,False
2024-10-08 22:40:00,15225,2412,0.04013136288998358,611,14614,False
2024-10-08 22:45:00,14974,2473,0.03559503138773875,533,14441,False
2024-10-08 22:50:00,15040,2446,0.04202127659574468,632,14408,False
2024-10-08 22:55:00,14530,2373,0.04322092222986924,628,13902,False
2024-10-08 23:00:00,14309,2322,0.05094695646096862,729,13580,False
2024-10-08 23:05:00,14877,2352,0.04066680110237279,605,14272,False
2024-10-08 23:10:00,15397,2426,0.03318828343183737,511,14886,False
2024-10-08 23:20:00,13927,2224,0.04983126301428879,694,13233,False
2024-10-08 23:25:00,14960,2382,0.04124331550802139,617,14343,False
2024-10-08 23:30:00,15388,2436,0.042500649857031454,654,14734,False
2024-10-08 23:35:00,15062,2472,0.02961094144203957,446,14616,False
2024-10-08 23:40:00,17677,2510,0.04084403462125926,722,16955,False
2024-10-08 23:45:00,22351,2489,0.03181065724128675,711,21640,False
2024-10-08 23:50:00,17067,2578,0.03621023026894006,618,16449,False
2024-10-08 23:55:00,15325,2504,0.018466557911908647,283,15042,False
2024-10-09 00:00:00,16607,2566,0.04576383452760884,760,15847,False
2024-10-09 00:05:00,17795,2625,0.04422590615341388,787,17008,False
2024-10-09 00:10:00,17051,2529,0.039352530643364025,671,16380,False
2024-10-09 00:15:00,17175,2713,0.026317321688500726,452,16723,False
2024-10-09 00:20:00,17270,2684,0.031615518239722064,546,16724,False
2024-10-09 00:25:00,17386,2680,0.02617048199700909,455,16931,False
2024-10-09 00:30:00,18298,2689,0.03524975407148322,645,17653,False
2024-10-09 00:35:00,18596,2789,0.031458378145837816,585,18011,False
2024-10-09 00:40:00,6593,1422,0.030486880024268165,201,6392,False
2024-10-09 00:50:00,18202,2976,0.03005164267662894,547,17655,False
2024-10-09 00:55:00,19411,3215,0.027252588738344238,529,18882,False
2024-10-09 01:00:00,20955,3356,0.04476258649486996,938,20017,False
2024-10-09 01:05:00,21114,3430,0.029269678886047173,618,20496,False
2024-10-09 01:10:00,21847,3551,0.03181214812102348,695,21152,False
2024-10-09 01:15:00,22366,3715,0.025440400608065815,569,21797,False
2024-10-09 01:20:00,22781,3707,0.025767086607260438,587,22194,False
2024-10-09 01:25:00,23517,3939,0.020028064804184207,471,23046,False
2024-10-09 01:30:00,23590,3808,0.025476896990250106,601,22989,False
2024-10-09 01:35:00,24556,4054,0.024841179345170224,610,23946,False
2024-10-09 01:40:00,11037,2297,0.017577240192081182,194,10843,False
2024-10-09 02:05:00,7287,1831,0.02003567997804309,146,7141,False
2024-10-09 02:10:00,28244,4598,0.022163999433508,626,27618,False
2024-10-09 02:15:00,52127,4819,0.021179043489938036,1104,51023,False
2024-10-09 02:20:00,53790,4791,0.011154489682097044,600,53190,False
2024-10-09 02:25:00,58392,5005,0.011302918207973694,660,57732,False
2024-10-09 02:30:00,47259,5084,0.023106709833047672,1092,46167,False
2024-10-09 02:35:00,2387,1081,0.0213657310431504,51,2336,False
2024-10-09 02:40:00,21554,3790,0.02329034054003897,502,21052,False
2024-10-09 02:45:00,34058,5304,0.021052322508661694,717,33341,False
2024-10-09 02:50:00,15882,3160,0.010640977206900893,169,15713,False
2024-10-09 03:00:00,25864,4523,0.0017012063099288586,44,25820,False
2024-10-09 03:05:00,57876,5870,0.005062547515377704,293,57583,False
2024-10-09 03:10:00,112055,5778,0.02336352683949846,2618,109437,False
2024-10-09 03:15:00,110931,5892,0.02095897449766071,2325,108606,False
2024-10-09 03:20:00,54844,5274,0.01885347531179345,1034,53810,False
2024-10-09 03:25:00,13642,3107,0.003738454772027562,51,13591,False
2024-10-09 03:30:00,40218,6386,0.018399721517728382,740,39478,False
2024-10-09 03:35:00,57317,6476,0.014637891027094929,839,56478,False
2024-10-09 03:40:00,83958,6592,0.014435789323233045,1212,82746,False
2024-10-09 03:45:00,79596,6473,0.007789336147545103,620,78976,False
2024-10-09 03:50:00,12675,2934,0.02106508875739645,267,12408,False
2024-10-09 03:55:00,43123,6786,0.018435637594787006,795,42328,False
2024-10-09 04:00:00,26122,4826,0.01657606615113697,433,25689,False
2024-10-09 04:05:00,25997,4917,0.01230911258991422,320,25677,False
2024-10-09 04:10:00,42645,7053,0.013624105991323718,581,42064,False
2024-10-09 04:15:00,41619,6861,0.01174944136091689,489,41130,False
2024-10-09 04:20:00,41342,6790,0.007885443374776256,326,41016,False
2024-10-09 04:30:00,30494,5473,0.015084934741260575,460,30034,False
2024-10-09 04:35:00,41720,7021,0.013279002876318313,554,41166,False
2024-10-09 04:40:00,1514,953,0.009907529722589167,15,1499,False
2024-10-09 04:45:00,39294,6800,0.008983559831017458,353,38941,False
2024-10-09 04:50:00,39085,6639,0.010617884098759115,415,38670,False
2024-10-09 04:55:00,27702,5211,0.012670565302144249,351,27351,False
2024-10-09 05:00:00,41942,6988,0.022078107863239712,926,41016,False
2024-10-09 05:05:00,38831,6819,0.0019829517653421236,77,38754,False
2024-10-09 05:10:00,40592,6908,0.0004927079227433977,20,40572,False
2024-10-09 05:15:00,15275,4385,0.010016366612111293,153,15122,False
2024-10-09 05:20:00,38967,6661,0.016475479251674495,642,38325,False
2024-10-09 05:25:00,34259,5978,0.02171692110102455,744,33515,False
2024-10-09 05:35:00,19789,4136,0.015816867956945778,313,19476,False
2024-10-09 05:40:00,37555,6407,0.017414458793769138,654,36901,False
2024-10-09 05:55:00,8981,2421,0.025052889433247967,225,8756,False
2024-10-09 06:00:00,36637,6476,0.024510740508229385,898,35739,False
2024-10-09 06:05:00,36655,6469,0.018005729095621335,660,35995,False
2024-10-09 06:10:00,38255,6542,0.01714808521761861,656,37599,False
2024-10-09 06:15:00,38547,6715,0.014190468778374451,547,38000,False
2024-10-09 06:20:00,6759,2748,0.016866400355082113,114,6645,False
2024-10-09 06:25:00,35637,6357,0.01296405421331762,462,35175,False
2024-10-09 06:30:00,36232,6365,0.015731949657761094,570,35662,False
2024-10-09 06:35:00,43677,6360,0.012775602719967031,558,43119,False
2024-10-09 06:40:00,29074,5510,0.012382197152094656,360,28714,False
2024-10-09 06:45:00,35700,6364,0.013445378151260505,480,35220,False
2024-10-09 06:50:00,25338,4929,0.01176099139632173,298,25040,False
2024-10-09 06:55:00,12842,3043,0.012381249026631366,159,12683,False
2024-10-09 07:00:00,44556,6405,0.013174432175240147,587,43969,False
2024-10-09 07:05:00,102613,6513,0.012201183085963766,1252,101361,False
2024-10-09 07:10:00,96686,6393,0.010311730757296817,997,95689,False
2024-10-09 07:15:00,25318,4930,0.010743344655975985,272,25046,False
2024-10-09 07:30:00,79473,5065,0.017175644558529313,1365,78108,False
2024-10-09 07:35:00,81097,6454,0.015302662243979432,1241,79856,False
2024-10-09 07:40:00,43740,6430,0.011545496113397348,505,43235,False
2024-10-09 07:45:00,35507,6363,0.013011518855436955,462,35045,False
2024-10-09 07:50:00,21462,4445,0.012953126456061876,278,21184,False
2024-10-09 07:55:00,26376,4995,0.012359720958447073,326,26050,False
2024-10-09 08:00:00,35680,6447,0.013536995515695068,483,35197,False
2024-10-09 08:05:00,19864,4174,0.013844140153040677,275,19589,False
2024-10-09 08:10:00,34756,3772,0.010127747727011164,352,34404,False
2024-10-09 08:15:00,49202,6292,0.013312466972887281,655,48547,False
2024-10-09 08:20:00,18900,4640,0.01328042328042328,251,18649,False
2024-10-09 08:25:00,35096,6450,0.013477319352632779,473,34623,False
2024-10-09 08:30:00,31580,5867,0.015674477517416085,495,31085,False
2024-10-09 08:35:00,26056,5013,0.012703408044212465,331,25725,False
2024-10-09 08:40:00,70017,6230,0.017624291243555138,1234,68783,False
2024-10-09 08:45:00,104625,6363,0.014050179211469534,1470,103155,False
2024-10-09 08:50:00,84849,6430,0.012209925868307228,1036,83813,False
2024-10-09 08:55:00,92644,6517,0.006336082207158585,587,92057,False
2024-10-09 09:00:00,106848,6481,0.01535826594788859,1641,105207,False
2024-10-09 09:05:00,63682,6696,0.013127728400489935,836,62846,False
2024-10-09 09:10:00,19309,4927,0.013361644828836294,258,19051,False
2024-10-09 09:15:00,36253,6615,0.01310236394229443,475,35778,False
2024-10-09 09:20:00,23431,5332,0.011949980794673723,280,23151,False
2024-10-09 09:25:00,36554,6695,0.012337911035727964,451,36103,False
2024-10-09 09:30:00,32811,6144,0.020084727682789308,659,32152,False
2024-10-09 09:35:00,22425,4613,0.012441471571906355,279,22146,False
2024-10-09 09:40:00,36145,6602,0.007691243602157975,278,35867,False
2024-10-09 09:45:00,43499,6527,0.010368054438033058,451,43048,False
2024-10-09 09:50:00,36803,6568,0.020079884792000652,739,36064,False
2024-10-09 09:55:00,37524,6650,0.019560814412109582,734,36790,False
2024-10-09 10:00:00,36852,6468,0.013296428959079561,490,36362,False
2024-10-09 10:05:00,36271,6485,0.01618372804720024,587,35684,False
2024-10-09 10:10:00,37362,6602,0.014239066431133237,532,36830,False
2024-10-09 10:15:00,37677,6709,0.013244154258566234,499,37178,False
2024-10-09 10:20:00,54525,6706,0.01265474552957359,690,53835,False
2024-10-09 10:25:00,38673,6782,0.011041294960308225,427,38246,False
2024-10-09 10:30:00,38599,6873,0.015492629342729086,598,38001,False
2024-10-09 10:35:00,50249,6867,0.01777149794025752,893,49356,False
2024-10-09 10:40:00,66024,6742,0.015146007512419726,1000,65024,False
2024-10-09 10:45:00,76162,6839,0.016780021533047976,1278,74884,False
2024-10-09 10:50:00,54586,6522,0.014527534532664053,793,53793,False
2024-10-09 10:55:00,24215,4943,0.016105719595292174,390,23825,False
2024-10-09 11:00:00,37703,6866,0.016868684189587035,636,37067,False
2024-10-09 11:05:00,20002,4339,0.01854814518548145,371,19631,False
2024-10-09 11:15:00,18821,3222,0.012486052813346794,235,18586,False
2024-10-09 11:20:00,78122,7175,0.013312511200430097,1040,77082,False
2024-10-09 11:25:00,72600,6721,0.01581267217630854,1148,71452,False
2024-10-09 11:30:00,4817,1857,0.014739464396927549,71,4746,False
2024-10-09 11:35:00,38563,7058,0.01273241189741462,491,38072,False
2024-10-09 11:40:00,32879,6215,0.01362571854375133,448,32431,False
2024-10-09 11:45:00,30127,5587,0.03375709496464965,1017,29110,False
2024-10-09 11:50:00,41580,7297,0.01418951418951419,590,40990,False
2024-10-09 11:55:00,38830,7168,0.0073139325263971156,284,38546,False
2024-10-09 12:00:00,74623,6994,0.014700561489085134,1097,73526,False
2024-10-09 12:05:00,44016,7018,0.014290258087968011,629,43387,False
2024-10-09 12:10:00,31838,6108,0.0155160500031409,494,31344,False
2024-10-09 12:20:00,3656,1561,0.015043763676148797,55,3601,False
2024-10-09 12:25:00,40217,7291,0.011562274659969665,465,39752,False
2024-10-09 12:30:00,39755,7268,0.011998490755879764,477,39278,False
2024-10-09 12:35:00,38491,7023,0.011171442674911018,430,38061,False
2024-10-09 12:40:00,63822,7183,0.011688759361975495,746,63076,False
2024-10-09 12:45:00,63286,7255,0.010144423727206649,642,62644,False
2024-10-09 12:50:00,66817,7220,0.011808372120867444,789,66028,False
2024-10-09 12:55:00,31667,6703,0.010420942937442763,330,31337,False
2024-10-09 13:00:00,39369,7171,0.013690975132718636,539,38830,False
2024-10-09 13:05:00,40260,7211,0.010755091902632886,433,39827,False
2024-10-09 13:10:00,40934,7209,0.011775052523574534,482,40452,False
2024-10-09 13:15:00,41020,7528,0.012164797659678206,499,40521,False
2024-10-09 13:20:00,40303,7537,0.012033843634468898,485,39818,False
2024-10-09 13:25:00,33268,6396,0.00865696765660695,288,32980,False
2024-10-09 13:30:00,39919,7528,0.0135273929707658,540,39379,False
2024-10-09 13:35:00,541,472,0.009242144177449169,5,536,True
2024-10-09 13:40:00,23991,4987,0.011712725605435372,281,23710,False
2024-10-09 13:45:00,40895,7452,0.010954884460202959,448,40447,False
2024-10-09 13:50:00,24003,5955,0.007415739699204266,178,23825,False
2024-10-09 13:55:00,42311,7841,0.012195410177022524,516,41795,False
2024-10-09 14:00:00,34697,7248,0.013228809407153356,459,34238,False
2024-10-09 14:05:00,43198,7875,0.007361451919070327,318,42880,False
2024-10-09 14:10:00,43723,7927,0.00919424559156508,402,43321,False
2024-10-09 14:15:00,45470,8131,0.009126896855069276,415,45055,False
2024-10-09 14:20:00,42813,8067,0.006002849601756476,257,42556,False
2024-10-09 14:25:00,43458,8045,0.006673109669105804,290,43168,False
2024-10-09 14:30:00,46234,8392,0.013799368430159623,638,45596,False
2024-10-09 14:35:00,44972,8243,0.007827092413057013,352,44620,False
2024-10-09 14:40:00,44706,8185,0.010803918937055429,483,44223,False
2024-10-09 14:45:00,46649,8443,0.012669081866706683,591,46058,False
2024-10-09 14:50:00,45810,8548,0.006068543986029251,278,45532,False
2024-10-09 14:55:00,49466,8422,0.0019407269639752558,96,49370,False
2024-10-09 15:00:00,32039,6481,0.00134211429819907,43,31996,False
2024-10-09 15:05:00,40959,7802,0.002832100393076003,116,40843,False
2024-10-09 15:10:00,41966,8341,0.006910356002478197,290,41676,False
2024-10-09 15:15:00,59538,9049,0.011051765259162216,658,58880,False
2024-10-09 15:20:00,94702,8876,0.007961817068277333,754,93948,False
2024-10-09 15:25:00,95690,8894,0.010262305361061761,982,94708,False
2024-10-09 15:30:00,82038,8115,0.010251346936785392,841,81197,False
2024-10-09 15:35:00,29144,6239,0.007857534998627505,229,28915,False
2024-10-09 15:40:00,47928,8908,0.009618594558504423,461,47467,False
2024-10-09 15:45:00,31964,7012,0.008384432486547366,268,31696,False
2024-10-09 15:50:00,39225,7726,0.006806883365200765,267,38958,False
2024-10-09 15:55:00,4841,2033,0.008056186738277215,39,4802,False
2024-10-09 16:00:00,47219,8989,0.009487706219953831,448,46771,False
2024-10-09 16:05:00,44323,8954,0.011641811249238545,516,43807,False
2024-10-09 16:10:00,53191,9483,0.008629279389370382,459,52732,False
2024-10-09 16:15:00,33525,7545,0.008232662192393736,276,33249,False
2024-10-09 16:20:00,42964,8668,0.008565310492505354,368,42596,False
2024-10-09 16:25:00,51555,9531,0.00830181359712928,428,51127,False
2024-10-09 16:30:00,40325,8814,0.014432734035957842,582,39743,False
2024-10-09 16:35:00,53363,9688,0.00991323576260705,529,52834,False
2024-10-09 16:40:00,18441,5502,0.006290331326934548,116,18325,False
2024-10-09 16:45:00,50334,9380,0.009516430245957008,479,49855,False
2024-10-09 16:50:00,20458,4876,0.007674259458402581,157,20301,False
2024-10-09 16:55:00,51181,9484,0.009085402786190187,465,50716,False
2024-10-09 17:00:00,40271,8542,0.012291723572794318,495,39776,False
2024-10-09 17:05:00,47958,9098,0.003690729388214688,177,47781,False
2024-10-09 17:10:00,49125,9205,0.009750636132315521,479,48646,False
2024-10-09 17:15:00,35702,8079,0.010951767407988347,391,35311,False
2024-10-09 17:20:00,51421,9324,0.009354154917251707,481,50940,False
2024-10-09 17:25:00,24502,5517,0.00910129785323647,223,24279,False
2024-10-09 18:20:00,29428,6027,0.00948076661682751,279,29149,False
2024-10-09 18:25:00,44160,8054,0.012998188405797102,574,43586,False
2024-10-09 18:30:00,54096,8472,0.012921472937000888,699,53397,False
2024-10-09 18:35:00,43268,7959,0.013867061107515948,600,42668,False
2024-10-09 18:40:00,912,701,0.020833333333333332,19,893,False
2024-10-09 18:45:00,38726,7447,0.009399369932345195,364,38362,False
2024-10-09 18:50:00,43194,8057,0.013288882715191925,574,42620,False
2024-10-09 19:00:00,15358,3873,0.011329600208360463,174,15184,False
2024-10-09 19:05:00,84197,7920,0.0116987541123793,985,83212,False
2024-10-09 19:10:00,54333,6605,0.013214804998803674,718,53615,False
2024-10-09 19:15:00,38976,7330,0.010981116584564861,428,38548,False
2024-10-09 19:20:00,83043,7017,0.012836723143431716,1066,81977,False
2024-10-09 19:25:00,80729,7045,0.015607774157985359,1260,79469,False
2024-10-09 19:30:00,56964,7050,0.01762516677199635,1004,55960,False
2024-10-09 19:35:00,22084,5092,0.02191631950733563,484,21600,False
2024-10-09 19:40:00,60794,6634,0.01475474553409876,897,59897,False
2024-10-09 19:45:00,37661,6338,0.012585964260109928,474,37187,False
2024-10-09 19:50:00,55598,6167,0.011097521493578906,617,54981,False
2024-10-09 19:55:00,48897,6048,0.013313700227007792,651,48246,False
2024-10-09 20:00:00,24576,4764,0.0147705078125,363,24213,False
2024-10-09 20:05:00,14348,3360,0.014845274602732089,213,14135,False
2024-10-09 20:10:00,30760,5662,0.02093628088426528,644,30116,False
2024-10-09 20:15:00,30294,5722,0.013732092163464712,416,29878,False
2024-10-09 20:20:00,5902,1873,0.009488309047780414,56,5846,False
2024-10-09 20:25:00,28445,5301,0.016980137106697137,483,27962,False
2024-10-09 20:30:00,40931,5116,0.02245241992621729,919,40012,False
2024-10-09 20:35:00,47083,4843,0.020580676677357006,969,46114,False
2024-10-09 20:40:00,43067,4746,0.020317180207583534,875,42192,False
2024-10-09 20:45:00,49925,4432,0.025057586379569355,1251,48674,False
2024-10-09 20:50:00,55505,4390,0.019241509773894244,1068,54437,False
2024-10-09 20:55:00,40059,4242,0.014303901744926234,573,39486,False
2024-10-09 21:00:00,23894,4131,0.02908680003348121,695,23199,False
2024-10-09 21:05:00,22086,3905,0.022729330797790454,502,21584,False
2024-10-09 21:10:00,5467,2043,0.012804097311139564,70,5397,False
2024-10-09 21:15:00,20934,3646,0.026368586987675552,552,20382,False
2024-10-09 21:20:00,20272,3547,0.024615232833464878,499,19773,False
2024-10-09 21:25:00,19187,3405,0.021524990879241153,413,18774,False
2024-10-09 21:30:00,19232,3402,0.033641846921797,647,18585,False
2024-10-09 21:35:00,10024,2098,0.03341979249800479,335,9689,False
2024-10-09 21:40:00,17712,3061,0.014509936766034327,257,17455,False
2024-10-09 21:45:00,16685,2963,0.023614024572969735,394,16291,False
2024-10-09 21:50:00,16523,2906,0.033710585244810264,557,15966,False
2024-10-09 21:55:00,12886,2431,0.03329194474623622,429,12457,False
2024-10-09 22:05:00,3864,1091,0.026397515527950312,102,3762,False
2024-10-09 22:10:00,16874,2756,0.05061040654260993,854,16020,False
2024-10-09 22:15:00,15773,2710,0.032397134343498384,511,15262,False
2024-10-09 22:20:00,14968,2576,0.03360502405130946,503,14465,False
2024-10-09 22:25:00,15292,2579,0.032042898247449644,490,14802,False
2024-10-09 22:30:00,6957,1468,0.04340951559580279,302,6655,False
2024-10-09 22:40:00,14764,2465,0.0478867515578434,707,14057,False
2024-10-09 22:45:00,14668,2490,0.03306517589310063,485,14183,False
2024-10-09 22:50:00,14721,2476,0.03749745261870797,552,14169,False
2024-10-09 22:55:00,15354,2478,0.04624202162302983,710,14644,False
2024-10-09 23:00:00,14221,2352,0.05189508473384431,738,13483,False
2024-10-09 23:25:00,8185,1609,0.034086744043982896,279,7906,False
2024-10-09 23:30:00,17960,2767,0.06575723830734967,1181,16779,False
2024-10-09 23:35:00,17072,2774,0.03122071227741331,533,16539,False
2024-10-09 23:40:00,17481,2816,0.038842171500486244,679,16802,False
2024-10-09 23:45:00,13030,2219,0.03867996930161167,504,12526,False
